a	aa1
abi	a b i1
aborigenams	a b o r i g e1 n a m s
aborigenų	a b o r i g e1 n uu
abu	a b u1
adaptavosi	a d a p t aa1 v oo s i
administraciniai	a d m i n i s t r aa1 ts i n e j
afrikoj	aa1 f r i k oo j
afrikoje	aa1 f r i k oo j e
afrikos	aa1 f r i k oo s
agresiją	a g r e1 s i j ea
aikštę	a1a j k s1 t ea
airijoje	a1 j1 r i j oo j e
aiškaus	a j s1 k a1 w1 s
aiškiai	a1a j s1 k e j
aiškindavęs	a1a j s1 k i n d a v ea s
aišku	a1a j s1 k u
akcentais	a k ts e1 n1 t a j s
akcentas	a k ts e1 n1 t a s
akelių	a k ea1 l uu
akimi	a k i m i1
akivaizdoje	a k i1 v a j z d oo j e
akmenimis	a k m e n i m i1 s
akmeniniais	a k m e n i1 n e j s
akmeninius	a k m e n i n u1 s
akmeninių	a k m e n i1 n uu
akmeninėmis	a k m e n i1 n ee m i s
akmeniu	aa1 k m e n u
akmens	a k m e1 n1 s
akmenys	aa1 k m e n ii s
akmenėliai	a k m e n ee1 l e j
akmenų	a k m e n uu1
akrobatai	a k r o b aa1 t a j
aktyviausi	a k t ii v e1a w s i
aktyviausia	a k t ii v e1a w s e
aktyvioje	a k t ii v oo j e1
akys	aa1 k ii s
aleksandriją	a l e k s a1a n d r i j ea
aliaskoje	a l ea1 s k oo j e
alksnių	a1 l1 k s n uu
amatininkų	a m a t i n i1 n1 k uu
amato	aa1 m a t oo
amerikos	a m e1 r i k oo s
amžiais	a1a m z1 e j s
amžiaus	a1a m z1 e w s
amžiuje	a1a m z1 u j e
amžius	a1a m z1 u s
anarchija	a n a1a r x i j e
anga	a n g a1
angelas	a1a n g e l a s
anglijoje	a1a n g l i j oo j e
anglijos	a1a n g l i j oo s
angliškos	a1a n g l i s1 k oo s
anglų	a1a n g l uu
angos	a n g oo1 s
angų	a n g uu1
ankstesniųjų	a n k s t e s n uu1 j uu
ankstesnį	a n k s t e1 s n ii
anksčiau	a n k s1 ts1 e1 w1
ansambliuose	a n s a1a m b l uo s e
ansamblių	a n s a1a m b l uu
ant	a n t
antano	a n t aa1 n oo
antarktidoje	a n t a r k t i1 d oo j e
antra	a n t r a
antrasis	a n t r a1 s i s
antroje	a n t r oo j e1
antrojoje	a n t r oo1 j oo j e
antropologas	a n t r o p o l o1 g a s
antrųjų	a n t r uu1 j uu
anuomet	a n uo1 m e t
apatinių	a p a t i1 n uu
apaugusius	a p a1a w g u s u s
apaugęs	a p a1a w g ea s
apeigas	aa1 p e j g a s
apeiginės	a p e j g i1 n ee s
apeigų	a p e j g uu1
apeina	a p e1 j1 n a
apgadintas	a b g a d i1 n t a s
apgaulingas	a b g a w l i1 n g a s
apgraužtų	a b g r a1a w s1 t uu
apgriauta	a b g r e w t a
apgyvendintą	a b g ii v e1a n d i n t aa
apibrėžta	a p i b r ee s1 t a
apibūdinami	a p i b uu1 d i n a m i
apibūdinimų	a p i b uu1 d i n i m uu
apie	a p ie
apimantis	a1 p i m a n t i s
apimties	a p i m t ie1 s
apipinti	a p i p i1 n t i
apjuostas	a p j uo s t a s
aplankyti	a p l a n k i1i t i
apleidžiama	a p l e j dz1 e m a
aplink	a p l i1 n1 k
aplinkai	aa1 p l i n k a j
apnašas	aa1 p n a s1 a s
apnašus	aa1 p n a s1 u s
aprašydavo	a p r a s1 i1i d a v oo
aprūpina	a p r u1u p i n a
apsaugą	a p s a w g aa
apsiginti	a p s i g i n t i
apsigyveno	a p s i g ii v ea1 n oo
apsireiškė	a p s i r e1a j s1 k ee
apsivogdavo	a p s i v oo1 g d a v oo
apsuptas	a1 p s u p t a s
aptakus	a p t a k u1 s
aptašytų	a p t a s1 i1i t uu
aptiko	a p t i1 k oo
aptikta	a p t i k t a
aptikti	a p t i1 k t i
aptikęs	a p t i1 k ea s
aptinkama	a p t i n k a m a
apuokų	a p u1o k uu
apylinkėse	a p i1i l i n k ee s e
apytikriai	a p i1i t i k r e j
ar	a r
arabijos	a r aa1 b i j oo s
arba	a r b a
archajiška	a r x aa1 j i s1 k a
archajiškas	a r x aa1 j i s1 k a s
archajiškos	a r x aa1 j i s1 k oo s
archeologai	a r x e o l o1 g a j
archeologiniai	a r x e o l o1 g i n e j
archeologiniais	a r x e o l o1 g i n e j s
archeologinių	a r x e o l o1 g i n uu
architektūra	a r x i t e k t uu r a1
architektūriniais	a r x i t e k t uu1 r i n e j s
architektūrinis	a r x i t e k t uu1 r i n i s
architektūrinių	a r x i t e k t uu1 r i n uu
architektūros	a r x i t e k t uu1 r oo s
architektūrą	a r x i t e k t uu1 r aa
ardo	a1 r1 d oo
arime	a r i m e1
arkliai	a r k l e1 j1
arkliams	a r k l e1a m s
arklių	a r k l uu1
arkties	a1a r k t ie s
armija	a1a r m i j e
armiją	a1a r m i j ea
artikuliacija	a r t i k u l ea1 ts i j e
asmenvardžiu	a s m e1a n v a r dz1 u
asmenys	aa1 s m e n ii s
asocijuojasi	a s o ts i j u1o j e s i
astronominiai	a s t r o n o1 m i n e j
atbaidyti	a d b a j d i1i t i
atgabenti	a d g a b e1a n t i
atiduodamas	a t i d u1o d a m a s
atiteko	a t i t ea1 k oo
atitempti	a t i t e1 m1 p t i
atitinka	a t i t i1 n1 k a
atkarpos	a t k a r p oo1 s
atkasama	a t k a s a m a
atkasamos	a1 t k a s a m oo s
atkastų	a t k a1 s t uu
atkeliavo	a t k e l ea1 v oo
atkurta	a t k u r t a
atkūrimo	a t k uu r i1 m oo
atlaikytų	a t l a j k i1i t uu
atlanto	a t l a1a n t oo
atleidžiami	a t l e j dz1 e m i1
atliekami	a t l ie k a m i1
atliekamos	a t l ie k a m oo s
atliekant	a t l ie1 k a n t
atlikdavo	a t l i1 g d a v oo
atliko	a t l i1 k oo
atliktas	a1 t l i k t a s
atmosferą	a t m o s f e1 r aa
atogrąžos	a t o1o g r aa z1 oo s
atogrąžose	a t o1o g r aa z1 oo s e
atogrąžų	a t o1o g r aa z1 uu
atpažinti	a t p a z1 i1 n t i
atpažįstamas	a t p a z1 i1i s t a m a s
atradimas	a t r a d i1 m a s
atradimui	a t r a d i1 m u j
atrastas	a1 t r a s t a s
atrastos	a t r a s t oo s
atrodo	a t r o1o d oo
atrodyti	a t r o1o d ii t i
atsakymų	a t s aa1 k ii m uu
atsargas	aa1 t s a r g a s
atsiduriama	a t s i d u r e m a
atsiduriame	a t s i1 d u r e m e
atsiradimo	a t s i r a d i1 m oo
atsirado	a t s i r aa1 d oo
atsirasti	a t s i r a1 s t i
atsiskyrėliams	a t s i s k i1i r ee l e m s
atsispindi	a t s i s p i1 n1 d i
atsispindintys	a t s i s p i1 n1 d i n t ii s
atsitiktinai	a t s i t i k t i n a1 j1
atsitraukė	a t s i t r a1a w k ee
atsivežti	a t s i v e1 s1 t i
atsivežė	a t s i1 v e z1 ee
atsižvelgdami	a t s i z1 v e l g d a m i1
atskira	a t s k i r a
atskiras	aa1 t s k i r a s
atskiromis	a t s k i r oo m i1 s
atskiroms	a t s k i r o1o m s
atskirti	a t s k i1 r t i
atskirų	a t s k i r uu1
atsparūs	a t s p aa1 r uu s
atspindintys	a t s p i1 n1 d i n t ii s
atspindėjo	a t s p i n d e1e j oo
atstatydavo	a t s t a t i1i d a v oo
atstatymo	a t s t aa1 t ii m oo
atstoja	a t s t o1o j e
atstovai	a t s t oo1 v a j
atstovauja	a t s t oo v a1a w j e
atstovų	a t s t oo1 v uu
atstumais	a t s t u1 m a j s
atstumams	a t s t u1 m a m s
atstumus	a t s t u m u1 s
atstumą	a t s t u1 m aa
atvaizdai	a t v a j z d a1 j1
atvaizdais	a t v a j z d a1 j1 s
atveju	aa1 t v e j u
atversti	a t v e1 r1 s t i
atverti	a t v e r t i
atvežti	a t v e1 s1 t i
atvykus	a t v ii1 k u s
atvykę	a t v ii1 k ea
atšiauri	a t s1 e w r i1
atšilimu	a t s1 i l i m u1
atžvilgiu	aa1 d z1 v i l g u
audiniais	a w d i n e1 j1 s
audinės	a w d i n ee s
audringiausiu	a w d r i n g e1a w s u
audrų	a w d r uu1
auga	a1a w g a
augalai	a w g a l a1 j1
augalais	a w g a l a1 j1 s
augaliją	a w g a l i1 j ea
augalų	a w g a l uu1
augančių	a1a w g a n ts1 uu
augindami	a w g i1 n d a m i
augmenijos	a w g m e n i1 j oo s
auklėtinis	a1a w k l ee t i n i s
auksinėmis	a w k s i n ee m i s
aukso	a1a w k s oo
aukšta	a w k s1 t a
aukštai	a w k s1 t a1 j1
aukštaitijos	a w k s1 t a j t i1 j oo s
aukštaičiai	a w k s1 t a1 j1 ts1 e j
aukštaičių	a w k s1 t a1 j1 ts1 uu
aukštapelkių	a w k s1 t aa1 p e l k uu
aukštas	a w k s1 t a s
aukštesnis	a w k s1 t e1 s n i s
aukštis	a1 w1 k s1 t i s
aukšto	a w k s1 t oo
aukštos	a w k s1 t oo s
aukštumo	a w k s1 t u m oo
aukštus	a w k s1 t u s
aukštutinės	a w k s1 t u t i1 n ee s
aukštyje	a1 w1 k s1 t ii j e
aukštyn	a w k s1 t ii1 n
aukštys	a w k s1 t ii s
aukštį	a1 w1 k s1 t ii
aukščiau	a w k s1 ts1 e1 w1
aukščiausiais	a w k s1 ts1 e1a w s e j s
aukščiausio	a w k s1 ts1 e1a w s oo
aukščiausios	a w k s1 ts1 e1a w s oo s
aukščiausiąją	a w k s1 ts1 e1a w s ea j ea
aukščio	a1 w1 k s1 ts1 oo
australijos	a w s t r aa1 l i j oo s
austrų	a1a w s t r uu
ausų	a w s uu1
autentiška	a w t e1 n1 t i s1 k a
automobilių	a w t o m o b i1 l uu
autorystę	a w t oo r ii1 s t ea
auš	a1 w1 s1
auštant	a1 w1 s1 t a n t
azijoje	aa1 z i j oo j e
azijos	aa1 z i j oo s
aš	a1 s1
aštriai	a s1 t r e1 j1
aštriais	a s1 t r e1 j1 s
aštuoni	a s1 t uo n i1
aštuoniasdešimt	a s1 t u1o n e z d e s1 i m t
aštuoniolikto	a s1 t uo n o1o l i k t oo
aštuonios	a s1 t u1o n oo s
aštuonis	a s1 t u1o n i s
aštuonių	a s1 t uo n uu1
badauti	b a d a1a w t i
baigia	b a1 j1 g e
baigiant	b a1 j1 g e n t
baigimo	b a j g i1 m oo
baigti	b a1 j1 k t i
baikalas	b a j k aa1 l a s
baikalo	b a j k aa1 l oo
baikalą	b a j k aa1 l aa
baikšti	b a j k s1 t i1
balsai	b a l s a1 j1
balsas	b a1 l1 s a s
balso	b a1 l1 s oo
balsų	b a l s uu1
baltai	b a l t a j
baltarusiai	b a l t a r u1 s e j
baltarusijai	b a l t a r u1 s i j e j
baltarusiją	b a l t a r u1 s i j ea
baltasis	b a l t a1 s i s
baltieji	b a l t i1e j i
baltojo	b a1a l t oo j oo
baltymų	b a l t ii m uu1
baltąjį	b a1a l t aa j ii
baltųjų	b a l t uu1 j uu
bando	b a1 n1 d oo
bandomis	b a n d oo m i1 s
banga	b a n g a1
bangas	b a n g a1 s
banginis	b a n g i1 n i s
banginių	b a n g i1 n uu
bangomis	b a n g oo m i1 s
banguojančios	b a n g u1o j e n ts1 oo s
baseine	b a s e j n e1
bažnytinio	b a z1 n i1i t i n oo
bažnyčia	b a z1 n i1i ts1 e
bažnyčiai	b a z1 n i1i ts1 e j
bažnyčios	b a z1 n i1i ts1 oo s
be	b e
bebrai	b ea1 b r a j
bebras	b ea1 b r a s
bebro	b ea1 b r oo
bebrus	b e b r u1 s
bebrų	b ea1 b r uu
bei	b e j
bendras	b e1 n1 d r a s
bendrauti	b e n d r a1a w t i
bendravimo	b e n d r aa1 v i m oo
bendri	b e n d r i1
bendrinė	b e n d r i1 n ee
bendro	b e1 n1 d r oo
bendruomeniniai	b e n d r uo m e n i1 n e j
bendruomenių	b e n d r u1o m e n uu
bendruomenėje	b e n d r u1o m e n ee j e
bendruomenės	b e n d r u1o m e n ee s
bene	b e n e1
bent	b e n t
bernelio	b e r n ea1 l oo
besikartojančiais	b e s i k a r t o1o j e n ts1 e j s
besikeičiantis	b e s i k e1 j1 ts1 e n t i s
besikeičiančios	b e s i k e1 j1 ts1 e n ts1 oo s
besikeičiančiu	b e s i k e1 j1 ts1 e n ts1 u
besikuriančios	b e s i1 k u r e n ts1 oo s
besniegių	b e s n ie1 g uu
bet	b e t
beveik	b e v e1a j k
beždžionė	b e z1 dz1 oo1 n ee
bibliotekai	b i b l i o t e1 k a j
biologas	b i o l o1 g a s
bizantinio	b i z a1a n t i n oo
bizantinėmis	b i z a1a n t i n ee m i s
blokai	b l o1 k a j
blokas	b l o1 k a s
blokus	b l o k u1 s
blokų	b l o1 k uu
bokštai	b o1o k s1 t a j
bokštas	b o1o k s1 t a s
bokštu	b o1o k s1 t u
bokštą	b o1o k s1 t aa
bokštų	b o1o k s1 t uu
brakonieriai	b r a k o n ie1 r e j
brangakmenius	b r a1a n g a k m e n u s
briedžio	b r i1e dz1 oo
britų	b r i1 t uu
bruožai	b r u1o z1 a j
bruožas	b r u1o z1 a s
bu	b u1
budistų	b u d i1 s t uu
buitis	b u j t i1 s
bulgarų	b u l g aa1 r uu
burtažodžiai	b u r t aa1 z1 oo dz1 e j
bus	b u1 s
buveinė	b u v e1 j1 n ee
buvo	b u1 v oo
buvusi	b u1 v u s i
buvusius	b u1 v u s u s
buvusią	b u1 v u s ea
byloja	b ii l o1o j e
bėgantis	b e1e g a n t i s
bū	b uu1
būdamas	b u1u d a m a s
būdas	b uu1 d a s
būdavo	b u1u d a v oo
būdinga	b uu d i1 n g a
būdingas	b uu d i1 n g a s
būdingi	b uu d i1 n g i
būdingą	b uu d i1 n g aa
būdu	b uu d u1
būklė	b u1u k l ee
būklę	b u1u k l ea
būna	b uu1 n a
būriai	b uu r e1 j1
būstuose	b u1u s t uo s e
būta	b uu t a
būti	b u1u t i
būtybėms	b uu t i1i b ee m s
būtybės	b uu t i1i b ee s
būtų	b u1u t uu
carinė	ts a r i1 n ee
celių	ts e1 l uu
celėse	ts e1 l ee s e
centimetro	ts e n t i m e1 t r oo
centimetrų	ts e n t i m e1 t r uu
centrai	ts e1 n1 t r a j
centras	ts e1 n1 t r a s
centriniam	ts e n t r i n e m
centrinėje	ts e n t r i1 n ee j e
centrinę	ts e n t r i1 n ea
centro	ts e1 n1 t r oo
centru	ts e n t r u1
centrą	ts e1 n1 t r aa
centrų	ts e1 n1 t r uu
chameleonai	x a m e l e o1 n a j
chorai	x o1 r a j
choru	x o r u1
chromosomos	x r o m o s o1 m oo s
chromosomų	x r o m o s o1 m uu
civilizacija	ts i v i l i z aa1 ts i j e
civilizacijos	ts i v i l i z aa1 ts i j oo s
civilizuotą	ts i v i l i z u1o t aa
colių	ts o1o l uu
dabar	d a b a1 r1
dabartinio	d a b a r t i1 n oo
dabartinė	d a b a r t i1 n ee
dabartinę	d a b a r t i1 n ea
daiktus	d a1a j k t u s
dainas	d a j n a1 s
dainava	d a j n a v a1
dainavimo	d a j n aa1 v i m oo
dainavo	d a j n aa1 v oo
dainingesnės	d a j n i n g e s n ee s
dainingos	d a j n i1 n g oo s
dainininkai	d a j n i n i1 n1 k a j
dainininkas	d a j n i n i1 n1 k a s
dainoms	d a j n o1o m s
dainos	d a j n oo1 s
dainose	d a j n oo s e1
dainuoja	d a j n u1o j e
dainuojama	d a j n u1o j e m a
dainuojamas	d a j n u1o j e m a s
dainuojame	d a j n u1o j e m e
dainuojamos	d a j n u1o j e m oo s
dainuojant	d a j n u1o j e n t
dainuojančių	d a j n u1o j e n ts1 uu
dainuojančiųjų	d a j n u1o j e n ts1 uu j uu
dainuoti	d a j n u1o t i
dainų	d a j n uu1
dali	d a l i1
dalia	d a l e1
dalimi	d a l i m i1
dalimis	d a l i m i1 s
daline	d a l i n e1
dalis	d a l i1 s
dalią	d aa1 l ea
dalių	d a l uu1
dalyje	d a l ii j e1
dalys	d aa1 l ii s
dalį	d aa1 l ii
dangalas	d a1 n1 g a l a s
dantis	d a n t i1 s
dantyta	d a n t i1i t a
dar	d a1a r
darbai	d a r b a j
darbas	d a1a r b a s
darbininku	d a r b i n i n k u1
darbininkų	d a r b i n i1 n1 k uu
darbus	d a1a r b u s
darbą	d a r b aa
darbų	d a r b uu1
daro	d aa1 r oo
daroma	d aa1 r oo m a
daromi	d aa1 r oo m i
darymas	d aa1 r ii m a s
daryti	d a r i1i t i
datos	d aa1 t oo s
datuojamos	d a t u1o j e m oo s
daug	d a1 w1 k
daugelio	d a1 w1 g e l oo
daugelis	d a1 w1 g e l i s
daugelyje	d a1 w1 g e l ii j e
daugelį	d a1 w1 g e l ii
daugiaaukštį	d a w g e a1 w1 k s1 t ii
daugiabalses	d a w g e b a l s e1 s
daugiakampius	d a w g e k a m p u s
daugiaspalvė	d a w g e s p a1 l1 v ee
daugiau	d a w g e1 w1
daugiausia	d a w g e1a w s e
daugiausiai	d a w g e1a w s e j
dauguma	d a w g u m a1
daugumos	d a w g u m oo1 s
daugumą	d a1 w1 g u m aa
daugybė	d a w g i1i b ee
daugybės	d a w g i1i b ee s
daugybę	d a w g i1i b ea
dažna	d a z1 n a
dažnai	d a z1 n a j
dažnam	d a z1 n a1a m
dažnas	d aa1 z1 n a s
dažniau	d a z1 n e1 w1
dažniausi	d a z1 n e1a w s i
dažniausia	d a z1 n e1a w s e
dažniausiai	d a z1 n e1a w s e j
dedamas	d ea1 d a m a s
degančio	d ea1 g a n ts1 oo
deginant	d ea1 g i n a n t
dekoratyvinių	d e k o r a t ii1 v i n uu
deoksiribonukleorūgščių	d e oo k s i r i b oo n u k l e oo r uu k s1 ts1 uu
deoksiribonuklieorūgščių	d e oo k s i r i b oo n u k l ie oo r uu k s1 ts1 uu
derliaus	d e1 r1 l e w s
derlingose	d e r l i1 n g oo s e
devintaisiais	d e v i n t a1 j1 s e j s
devintame	d e v i n t a m e1
devyni	d e v ii n i1
devyniasdešimt	d e v i1i n e z d e s1 i m t
devynioliktam	d e v ii n o1o l i k t a m
devynioliktame	d e v ii n o1o l i k t a m e
devyniolikto	d e v ii n o1o l i k t oo
devynios	d e v i1i n oo s
devynis	d e v i1i n i s
devynių	d e v ii n uu1
dešimt	d ea1 s1 i m t
dešimties	d e s1 i m t ie1 s
dešimtis	d ea1 s1 i m t i s
dešimtmeti	d e s1 i1 m1 t m e t i
dešimtmetį	d e s1 i1 m1 t m e t ii
dešimtmečiais	d e s1 i1 m1 t m e ts1 e j s
dešimtmečio	d e s1 i1 m1 t m e ts1 oo
dešimtuosius	d e s1 i m t u1o s u s
dešiniajame	d e s1 i n ea1 j e m e
dideli	d i d e l i1
dideliam	d i d e l e1a m
dideliems	d i d e l i1e m s
didelius	d i1 d e l u s
didelių	d i d e l uu1
didelė	d i1 d e l ee
didelės	d i d e l ee s
didelę	d i1 d e l ea
didesni	d i d e s n i1
didesnis	d i d e1 s n i s
didesnė	d i d e1 s n ee
didumą	d i d u m aa
diduomenės	d i d u1o m e n ee s
didysis	d i d ii1 s i s
didėti	d i d e1e t i
didįjį	d i1 d ii j ii
didžiajam	d i dz1 e1a j e m
didžiausias	d i dz1 e1a w s e s
didžiausio	d i dz1 e1a w s oo
didžiausių	d i dz1 e1a w s uu
didžioji	d i dz1 o1o j i
didžiojo	d i1 dz1 oo j oo
didžiosios	d i dz1 oo1 s oo s
didžiules	d i dz1 u l e1 s
didžiuliai	d i dz1 u1 l e j
didžiulis	d i dz1 u1 l i s
didžiulius	d i dz1 u l u1 s
didžiulių	d i dz1 u1 l uu
didžiulė	d i dz1 u1 l ee
didžiulę	d i dz1 u1 l ea
didžiuosius	d i dz1 u1o s u s
didžiąją	d i1 dz1 ea j ea
didžių	d i dz1 uu1
didžiųjų	d i dz1 uu1 j uu
diena	d ie n a1
dienas	d ie n a1 s
dienoms	d ie n o1o m s
dienovidinio	d ie n o1o v i d i n oo
dieną	d ie1 n aa
dienų	d ie n uu1
dievais	d ie v a1 j1 s
dievas	d ie1 v a s
dievo	d ie1 v oo
dievų	d ie v uu1
dinamitu	d i n a m i t u1
dinozaurų	d i n o z a1a w r uu
dirba	d i1 r b a
dirbinių	d i r b i n uu1
dirbo	d i1 r b oo
dirbta	d i r p t a
dirbtinis	d i r p t i1 n i s
dirbtuvės	d i r p t u1 v ee s
dokumentuot	d o k u m e n t u1o t
dokumentuoti	d o k u m e n t u1o t i
dominuojančia	d o m i n u1o j e n ts1 e
draudžiami	d r a w dz1 e m i1
drebėjimai	d r e b e1e j i m a j
drebėjimams	d r e b e1e j i m a m s
drebėjimas	d r e b e1e j i m a s
drebėjimus	d r e b e1e j i m u s
driekiasi	d r ie1 k e s i
driežai	d r ie z1 a j
drožinių	d r oo z1 i n uu1
druskingu	d r u s k i1 n g u
druskų	d r u1 s k uu
du	d u1
dubens	d u b e1 n1 s
dugnas	d u1 g n a s
dugne	d u g n e1
dukters	d u k t e1 r1 s
dulkių	d u l k uu
dumblo	d u1 m1 b l oo
duoda	d u1o d a
duomenimis	d uo m e n i m i1 s
duomenis	d u1o m e n i s
durimis	d u1 r i m i s
durpynuose	d u r p i1i n uo s e
dvaro	d v aa1 r oo
dvasininkų	d v aa1 s i n i n k uu
dvelkiantis	d v e1 l1 k e n t i s
dvi	d v i1
dvidešimt	d v i1 d e s1 i m t
dvidešimtajame	d v i d e s1 i m t aa1 j e m e
dvidešimtame	d v i d e s1 i m t a m e1
dvidešimties	d v i1 d e s1 i m t ie s
dvidešimto	d v i d e s1 i1 m1 t oo
dvidešimtojo	d v i d e s1 i1 m1 t oo j oo
dviejų	d v ie j uu1
dviem	d v i1e m
dvigubai	d v i1 g u b a j
dvigubus	d v i1 g u b u s
dvigubų	d v i1 g u b uu
dvylika	d v i1i l i k a
dvyliktame	d v i1i l i k t a m e
dvyliktas	d v i1i l i k t a s
dydis	d ii1 d i s
dydį	d ii1 d ii
dydžiai	d ii1 dz1 e j
dydžiais	d ii1 dz1 e j s
dydžio	d ii1 dz1 oo
dykumoje	d ii k u m oo j e1
dykumos	d ii k u m oo1 s
dykumą	d ii1 k u m aa
dykumų	d ii k u m uu1
dzūkai	dz uu1 k a j
dzūkams	dz uu1 k a m s
dzūkija	dz uu k i j e1
dzūkijos	dz uu k i1 j oo s
dzūkų	dz uu1 k uu
dėjo	d e1e j oo
dėka	d ee k a1
dėl	d ee l
dūmai	d uu m a j
dūmu	d u1u m u
dūmų	d uu m uu
egipto	e g i1 p t oo
egiptui	e g i1 p t u j
egzistavo	e g z i s t aa1 v oo
egzistuoti	e g z i s t u1o t i
eilėmis	e j l ee m i1 s
ekonominis	e k o n o1 m i n i s
ekonominių	e k o n o1 m i n uu
ekspedicija	e k s p e d i1 ts i j e
ekspedicijos	e k s p e d i1 ts i j oo s
ekspediciją	e k s p e d i1 ts i j ea
eksponuojami	e k s p o n u1o j e m i
elementai	e l e m e1 n1 t a j
elgtis	e1 l1 k t i s
emalis	e m aa1 l i s
era	e r a1
erelis	e r ea1 l i s
erozija	e r o1 z i j e
erą	e1 r aa
erškėtis	e r s1 k ee1 t i s
esamų	e s a m uu1
esant	ea1 s a n t
esantis	ea1 s a n t i s
esančiomis	ea1 s a n ts1 oo m i s
esančios	ea1 s a n ts1 oo s
esančiuose	ea1 s a n ts1 uo s e
esančių	ea1 s a n ts1 uu
esate	ea1 s a t e
eskizai	e s k i1 z a j
esmės	e s m ee s
estijos	e1 s t i j oo s
estiją	e1 s t i j ea
esu	e s u1
etapas	e t aa1 p a s
etinių	e1 t i n uu
etninio	e1 t n i n oo
etninių	e1 t n i n uu
europietis	e w r o p ie1 t i s
europoje	e w r o1 p oo j e
europos	e w r o1 p oo s
ežeras	ea1 z1 e r a s
ežere	e z1 e r e1
ežero	ea1 z1 e r oo
ežeru	ea1 z1 e r u
ežerus	ea1 z1 e r u s
ežerą	ea1 z1 e r aa
ežerų	e z1 e r uu1
ežys	e z1 ii1 s
faktai	f aa1 k t a j
faraonams	f a r a o1 n a m s
faraonas	f a r a o1 n a s
faraonų	f a r a o1 n uu
faunai	f a1a w n a j
feodalai	f e o d aa1 l a j
ferma	f e1 r m a
figūra	f i g uu r a1
figūras	f i g uu r a1 s
figūros	f i g uu1 r oo s
figūrų	f i g uu1 r uu
filosofiją	f i l o s o1 f i j ea
fiordai	f o1 r d a j
fiordas	f o1 r d a s
fiorduose	f o1 r d uo s e
fiordų	f o1 r d uu
flamingas	f l a m i1 n g a s
florai	f l o1 r a j
folklore	f o l k l o r e1
folkloro	f o l k l o1 r oo
forma	f o1 r m a
formavimosi	f o r m aa1 v i m oo s i
formavosi	f o r m aa1 v oo s i
formos	f o1 r m oo s
formuojasi	f o r m u1o j e s i
formuot	f o r m u1o t
formuotas	f o r m u1o t a s
formuoti	f o r m u1o t i
formų	f o1 r m uu
fregata	f r e g a t a1
freskomis	f r e1 s k oo m i s
freskų	f r e1 s k uu
frontoną	f r o n t o1 n aa
gabalas	g aa1 b a l a s
gabalų	g a b a l uu1
gabarituose	g a b a r i1 t uo s e
gabenami	g a b ea1 n a m i
gaida	g a j d a1
gaidą	g a1 j1 d aa
galbūt	g a l b u1u t
gale	g a l e1
gali	g aa1 l i
galima	g aa1 l i m a
galimybės	g a l i m i1i b ee s
galimų	g a l i m uu1
galingas	g a l i1 n g a s
galingi	g a l i1 n g i
galią	g aa1 l ea
galutinai	g a l u t i n a1 j1
galva	g a l v a1
galvą	g a1a l v aa
galėjo	g a l e1e j oo
galėtumėte	g a l e1e t u m ee t e
galėtų	g a l e1e t uu
galėčiau	g a l e1e ts1 e w
galų	g a l uu1
gaminamos	g a m i1 n a m oo s
gamtai	g a1 m1 t a j
gamtininkai	g a1 m1 t i n i n k a j
gamtinių	g a m t i1 n uu
gamtos	g a m t oo1 s
gamtovaizdį	g a m t o1o v a j z d ii
gana	g a n a1
ganėtinai	g a n e1e t i n a j
garbei	g a1 r1 b e j
garnio	g a1 r1 n oo
garsai	g a r s a1 j1
garsas	g a1 r1 s a s
garsažodžių	g a r s aa1 z1 oo dz1 uu
garso	g a1 r1 s oo
garsus	g a r s u1 s
gatvių	g aa1 t v uu
gaubia	g a1 w1 b e
gaudo	g a1a w d oo
gaudyklėse	g a w d ii1 k l ee s e
gaudyti	g a1a w d ii t i
gaują	g a1 w1 j ea
gausiai	g a1 w1 s e j
gausu	g a w s u1
gausumą	g a w s u1 m aa
gauti	g a1a w t i
gavo	g aa1 v oo
gebantis	g ea1 b a n t i s
gedimino	g e d i m i1 n oo
geležinėmis	g e l e z1 i1 n ee m i s
generolo	g e n e r oo1 l oo
generolų	g e n e r oo1 l uu
genčių	g e n ts1 uu1
geografinė	g e o g r aa1 f i n ee
geologų	g e o l o1 g uu
geometrines	g e o m e1 t r i n e s
geometrinių	g e o m e1 t r i n uu
gerai	g e r a1 j1
gerbiami	g e r b e m i1
geriau	g e r e1 w1
geriausia	g e r e1a w s e
geriu	g e r u1
gerklę	g e1a r k l ea
gero	g ea1 r oo
gerokai	g e r o1o k a j
gervė	g e1a r v ee
gerą	g ea1 r aa
gestu	g e s t u1
gestų	g e1 s t uu
gido	g i1 d oo
giesmės	g ie s m ee s
gigantiški	g i g a1a n t i s1 k i
gilesnis	g i l e1 s n i s
giliausi	g i l e1a w s i
giliausia	g i l e1a w s e
giliausias	g i l e1a w s e s
gilius	g i l u1 s
gilyn	g i l ii1 n
giminių	g i m i n uu1
gimtadienis	g i m t aa1 d ie n i s
gindami	g i n d a m i1
ginklai	g i1 n1 k l a j
ginčai	g i1 n1 ts1 a j
girdimas	g i1 r1 d i m a s
glūdi	g l uu1 d i
gniaužiantis	g n e1a w z1 e n t i s
gotikos	g o1 t i k oo s
graikijos	g r a1 j1 k i j oo s
graikiško	g r a1 j1 k i s1 k oo
graikiškojo	g r a1 j1 k i s1 k oo j oo
graikų	g r a1 j1 k uu
gramų	g r aa1 m uu
grandinė	g r a n d i1 n ee
grandinės	g r a n d i1 n ee s
grandinę	g r a n d i1 n ea
grasint	g r a s i1 n t
grasinti	g r a s i1 n t i
graužti	g r a1a w s1 t i
gražios	g r a z1 oo s
greitai	g r e1 j1 t a j
greitam	g r e j t a1a m
greitesnė	g r e j t e1 s n ee
greitis	g r e1 j1 t i s
greitį	g r e1 j1 t ii
grenlandijoje	g r e n l a1a n d i j oo j e
greta	g r e t a1
gretimose	g r e t i m oo s e1
griaučių	g r e1a w ts1 uu
griežtai	g r ie s1 t a j
grindų	g r i n d uu1
grioveliai	g r oo v ea1 l e j
grioviai	g r oo v e1 j1
griovius	g r oo v u1 s
grobiui	g r oo1 b u j
grobį	g r oo1 b ii
groži	g r oo1 z1 i
grublėtą	g r u b l e1e t aa
grumstas	g r u1 m1 s t a s
gruntas	g r u1 n1 t a s
grupe	g r u p e1
grupuojami	g r u p u1o j e m i
grupė	g r u1 p ee
grupėmis	g r u1 p ee m i s
grupės	g r u1 p ee s
gruzinų	g r u z i1 n uu
grąžą	g r aa1 z1 aa
grėsmę	g r ee1 s m ea
grėsė	g r ee1 s ee
gręžė	g r ea1 z1 ee
gubernatorius	g u b e r n aa1 t o r u s
gulyklos	g u l ii1 k l oo s
gulyklų	g u l ii1 k l uu
gydymo	g i1i d ii m oo
gyli	g ii1 l i
gylio	g ii1 l oo
gylis	g ii1 l i s
gyly	g ii1 l ii
gylyje	g ii1 l ii j e
gylį	g ii1 l ii
gynimo	g ii n i1 m oo
gynusios	g i1i n u s oo s
gynyba	g ii n i1i b a
gynybai	g ii n i1i b a j
gynybiniai	g ii n i1i b i n e j
gynybiniais	g ii n i1i b i n e j s
gynybinis	g ii n i1i b i n i s
gynybinių	g ii n i1i b i n uu
gynybinė	g ii n i1i b i n ee
gynybinį	g ii n i1i b i n ii
gynybą	g ii n i1i b aa
gyvas	g i1i v a s
gyvena	g ii v ea1 n a
gyvenamieji	g ii v ea1 n a m ie j i
gyvenamojoje	g ii v ea1 n a m oo j oo j e
gyvenamose	g ii v ea1 n a m oo s e
gyvenamuose	g ii v ea1 n a m uo s e
gyvenamųjų	g ii v ea1 n a m uu j uu
gyvenančių	g ii v ea1 n a n ts1 uu
gyvenimai	g ii v ea1 n i m a j
gyvenimas	g ii v ea1 n i m a s
gyvenimo	g ii v ea1 n i m oo
gyvenimu	g ii v ea1 n i m u
gyvenimui	g ii v ea1 n i m u j
gyvenimą	g ii v ea1 n i m aa
gyveno	g ii v ea1 n oo
gyvent	g ii v e1a n t
gyventi	g ii v e1a n t i
gyventoj	g ii v e1a n t oo j
gyventojai	g ii v e1a n t oo j e j
gyventojams	g ii v e1a n t oo j e m s
gyventoju	g ii v e1a n t oo j u
gyventojų	g ii v e1a n t oo j uu
gyvenu	g ii v e n u1
gyvenusi	g ii v ea1 n u s i
gyvenusių	g ii v ea1 n u s uu
gyvenviete	g ii v e1a n v ie t e
gyvenvietes	g ii v e1a n v ie t e s
gyvenvietė	g ii v e1a n v ie t ee
gyvoji	g ii v o1o j i
gyvojoje	g ii v oo1 j oo j e
gyvsidabris	g i1i v s i d a b r i s
gyvuliai	g ii v u l e1 j1
gyvuliams	g ii v u l e1a m s
gyvulių	g ii v u l uu1
gyvybės	g ii v i1i b ee s
gyvūnai	g ii v uu1 n a j
gyvūniją	g ii v uu n i1 j ea
gyvūnu	g ii v uu n u1
gyvūnus	g ii v uu n u1 s
gyvūnų	g ii v uu1 n uu
gyvų	g ii v uu1
gėlavandenis	g ee l a v a n d ea1 n i s
gėlo	g ee1 l oo
harmonija	h a r m o1 n i j e
helio	h e1 l oo
herbai	h e1 r b a j
hetitu	h e t i t u
hetitų	h e t i t uu
hidroelektrinę	h i d r o e l e k t r i1 n ea
hieroglifais	h ie r o1 g l i f a j s
himnai	h i1 m n a j
hipotezė	h i p o t e1 z ee
hipotezę	h i p o t e1 z ea
horizonte	h o r i z o1 n t e
hunai	h u1 n a j
ie	jie
ieškanti	ji1e s1 k a n t i
ieškotoj	jie s1 k o1o t oo j
ieškotojai	jie s1 k o1o t oo j e j
iki	i k i
ikonų	i k o1 n uu
ilgai	i l g a j
ilgas	i1 l g a s
ilgiausia	i l g e1a w s e
ilgiausias	i l g e1a w s e s
ilgiausios	i l g e1a w s oo s
ilgio	i1 l1 g oo
ilgis	i1 l1 g i s
ilgiu	i l g u1
ilgiui	i1 l1 g u j
ilgius	i l g u1 s
ilgo	i1 l g oo
ilgą	i1 l g aa
ilgų	i l g uu1
ilsisi	i1 l s i s i
ima	i1 m a
imdavo	i1 m1 d a v oo
imperatoriai	i m p e r aa1 t o r e j
imperatoriaus	i m p e r aa1 t o r e w s
imperatorius	i m p e r aa1 t o r u s
imperatorių	i m p e r aa1 t o r uu
imperatorė	i m p e r aa1 t o r ee
imperija	i m p e1 r i j e
imperijoje	i m p e1 r i j oo j e
imperijos	i m p e1 r i j oo s
impozantiškų	i m p o z a1a n t i s1 k uu
imta	i m t a
imti	i1 m1 t i
indais	i1 n1 d a j s
indėnai	i n d e1e n a j
infekcinės	i n f e1 k ts i n ee s
informaciją	i n f o r m aa1 ts i j ea
ingų	i1 n g uu
iniciatyva	i n i ts i a t ii v a1
inkai	i1 n k a j
inku	i1 n k u
inkų	i1 n k uu
instrukcijos	i n s t r u1 k ts i j oo s
instrumentai	i n s t r u m e1 n1 t a j
instrumentais	i n s t r u m e1 n1 t a j s
instrumentų	i n s t r u m e1 n1 t uu
intarpai	i1 n1 t a r p a j
intensyviai	i n t e n s ii v e1 j1
intensyvios	i n t e n s ii v oo s
interesams	i n t e r e1 s a m s
ir	i r
irano	i r aa1 n oo
islamo	i s l aa1 m oo
islamą	i s l aa1 m aa
islandijoje	i s l a1a n d i j oo j e
ispanu	i s p a n u1
ispanų	i s p aa1 n uu
istorija	i s t o1 r i j e
istorijoje	i s t o1 r i j oo j e
istoriją	i s t o1 r i j ea
istorikas	i s t o1 r i k a s
istoriniai	i s t o1 r i n e j
istorinio	i s t o1 r i n oo
istorinis	i s t o1 r i n i s
istorinius	i s t o1 r i n u s
istorinė	i s t o1 r i n ee
itin	i1 t i n
iš	i s1
išaugo	i s1 a1a w g oo
išaugus	i s1 a1a w g u s
išbarstyti	i z1 b a r s t i1i t i
išdabinta	i z1 d a b i1 n t a
išduodamas	i z1 d u1o d a m a s
išdėstyti	i z1 d e1e s t ii t i
išdėstytų	i z1 d e1e s t ii t uu
išdžiovintų	i z1 dz1 oo v i1 n t uu
išgaubti	i z1 g a w p t i
išgraužęs	i z1 g r a1a w z1 ea s
išgrįstą	i1 z1 g r ii s t aa
išgyvendavo	i z1 g ii v e1a n d a v oo
išgyventi	i z1 g ii v e1a n t i
išilgai	i s1 i l g a1 j1
iškart	i s1 k a1 r1 t
iškilus	i s1 k i l u s
iškilusi	i s1 k i1 l u s i
iškišamos	i1 s1 k i s1 a m oo s
išklotų	i s1 k l o1o t uu
išlaikyti	i s1 l a j k i1i t i
išlieka	i s1 l ie1 k a
išliko	i s1 l i1 k oo
išlikę	i s1 l i1 k ea
išlygino	i s1 l i1i g i n oo
išmargintos	i s1 m a1a r g i n t oo s
išmatuota	i s1 m a t u1o t a
išmatuotas	i s1 m a t u1o t a s
išmatuoti	i s1 m a t u1o t i
išmintingas	i s1 m i n t i1 n g a s
išmėginti	i s1 m ee g i1 n t i
išnyko	i s1 n ii1 k oo
išnyks	i s1 n ii1 k s
išnykę	i s1 n ii1 k ea
išorinis	i s1 oo r i1 n i s
išorės	i1 s1 oo r ee s
išorę	i1 s1 oo r ea
išpildymo	i s1 p i1 l d ii m oo
išpjauna	i s1 p j e1a w n a
išplėsti	i s1 p l ee1 s t i
išradimas	i s1 r a d i1 m a s
išradimus	i s1 r a d i m u1 s
išraizgę	i s1 r a1 j1 z g ea
išrastas	i1 s1 r a s t a s
išrastų	i s1 r a1 s t uu
išraustu	i s1 r a w s t u1
išraustų	i s1 r a1 w1 s t uu
išrikiuota	i s1 r i k u1o t a
išryškėja	i s1 r ii s1 k e1e j e
išsaugoti	i s1 s a1a w g oo t i
išsidėstę	i s1 s i d e1e s t ea
išsidėstęs	i s1 s i d e1e s t ea s
išsilaipino	i s1 s i l a j p i1 n oo
išsilavinusi	i s1 s i l aa1 v i n u s i
išsiliejo	i s1 s i l i1e j oo
išsilydžiusioms	i s1 s i l i1i dz1 u s oo m s
išsiplėtė	i s1 s i1 p l ee t ee
išsiruošia	i s1 s i r uo1 s1 e
išsiskiria	i s1 s i1 s k i r e
išskirti	i s1 s k i1 r t i
išskobtos	i s1 s k oo p t oo s
ištirpimo	i s1 t i r p i1 m oo
ištirta	i s1 t i1 r t a
ištisinę	i s1 t i s i1 n ea
ištisus	i1 s1 t i s u s
ištremta	i s1 t r e m t a
ištyrė	i s1 t i1i r ee
išvadą	i1 s1 v a d aa
išvarpyta	i s1 v a r p i1i t a
išvysto	i s1 v i1i s t oo
ja	j e1
jam	j e1a m
jame	j e m e1
japonai	j e p o1 n a j
japonijoje	j e p o1 n i j oo j e
japonijos	j e p o1 n i j oo s
jas	j e1 s
jau	j e w
jauna	j e w n a
jaunikliai	j e w n i1 k l e j
jauniklius	j e w n i k l u1 s
jauniklių	j e w n i1 k l uu
jaunuolynų	j e w n uo l i1i n uu
jausmus	j e w s m u1 s
jav	j e v
jei	j e1a j
ji	j i1
jie	j ie1
jiems	j i1e m s
jis	j i1 s
jo	j oo1
jog	j oo k
joje	j oo j e1
jok	j o1o k
jokių	j oo k uu1
jomis	j oo m i1 s
joms	j o1o m s
jos	j oo1 s
joti	j o1o t i
juda	j u1 d a
judrus	j u d r u1 s
judėjimo	j u d e1e j i m oo
jums	j u1 m s
jungiančių	j u1 n g e n ts1 uu
jungiasi	j u1 n g e s i
jungtinėse	j u n k t i1 n ee s e
juodkalnijoje	j uo t k a l n i1 j oo j e
juos	j uo1 s
juose	j uo s e1
juosia	j u1o s e
juostų	j u1o s t uu
ją	j ea1
jį	j ii1
jūra	j u1u r a
jūras	j u1u r a s
jūros	j u1u r oo s
jų	j uu1
kaba	k aa1 b a
kablelis	k a b l ea1 l i s
kad	k a t
kada	k a d a1
kadaise	k a d a1a j s e
kai	k a j
kailiu	k a1a j l u
kaimai	k a1a j m a j
kaimynai	k a j m i1i n a j
kaimynus	k a j m i1i n u s
kaimynystėje	k a j m ii n ii1 s t ee j e
kaimynystės	k a j m ii n ii1 s t ee s
kaip	k a1 j1 p
kaklas	k aa1 k l a s
kalba	k a l b a
kalbančia	k a1 l1 b a n ts1 e
kalboje	k a l b oo j e1
kalbos	k a l b oo1 s
kalbų	k a l b uu1
kalendorines	k a l e n d oo1 r i n e s
kalinių	k a l i n uu1
kalnai	k a l n a1 j1
kalnakasei	k a l n aa1 k a s e j
kalnakasiai	k a l n a k a s e1 j1
kalnas	k a1a l n a s
kalne	k a l n e1
kalno	k a1a l n oo
kalnu	k a1a l n u
kalnuose	k a l n uo s e1
kalnuotomis	k a l n u1o t oo m i s
kalnus	k a1a l n u s
kalną	k a1a l n aa
kalnų	k a l n uu1
kalvagūbrius	k a l v aa1 g uu b r u s
kalvas	k a l v a1 s
kalvystė	k a l v ii1 s t ee
kalvystės	k a l v ii1 s t ee s
kalėjimas	k a l e1e j i m a s
kam	k a1a m
kambarys	k a m b a r ii1 s
kampelių	k a m p ea1 l uu
kanadoj	k a n aa1 d oo j
kanadoje	k a n aa1 d oo j e
kanalo	k a n aa1 l oo
kanalu	k a n a l u1
kanalų	k a n aa1 l uu
kandžiai	k a1 n1 dz1 e j
kanjonas	k a n j o1 n a s
kanjono	k a n j o1 n oo
kanjoną	k a n j o1 n aa
kankinės	k a n k i n ee s
kapai	k a p a j
kapavietės	k a p aa1 v ie t ee s
kapavietę	k a p aa1 v ie t ea
kapaviečių	k a p aa1 v ie ts1 uu
kapinynas	k a p i n i1i n a s
kaprizingai	k a p r i z i1 n g a j
kapsų	k a1 p s uu
karai	k a r a1 j1
karaliams	k a r aa1 l e m s
karaliaus	k a r aa1 l e w s
karalienėms	k a r a l i1e n ee m s
karalienės	k a r a l i1e n ee s
karaliui	k a r aa1 l u j
karališkosios	k a r aa1 l i s1 k oo s oo s
karalių	k a r aa1 l uu
karalyste	k a r a l ii s t e1
karalystė	k a r a l ii1 s t ee
karalystę	k a r a l ii1 s t ea
karas	k aa1 r a s
karavanu	k a r a v a n u1
karavanų	k a r a v aa1 n uu
karbonato	k a r b o n aa1 t oo
kareivinėmis	k a r e j v i1 n ee m i s
kareiviu	k a r e j v u1
kareivių	k a r e1 j1 v uu
kariai	k a r e1 j1
kariauna	k a r e w n a1
karių	k a r uu1
karo	k aa1 r oo
kartais	k a1 r1 t a j s
karto	k a1 r1 t oo
kartojasi	k a r t o1o j e s i
kartu	k a r t u1
kartus	k a r t u1 s
kartą	k a1 r1 t aa
kartų	k a r t uu
karus	k a r u1 s
karštyje	k a1 r1 s1 t ii j e
kas	k a1 s
kasa	k a s a
kasant	k aa1 s a n t
kasdami	k a z d a m i1
kaskadų	k a s k aa1 d uu
kasyklų	k a s ii1 k l uu
kat	k a t
katalikais	k a t a l i1 k a j s
katastrofiškai	k a t a s t r o1 f i s1 k a j
katastrofiškas	k a t a s t r o1 f i s1 k a s
katu	k a t u1
kaulus	k a1a w l u s
kaupia	k a1 w1 p e
kažin	k a z1 i1 n
kažkam	k a s1 k a1a m
kažkur	k a s1 k u1 r1
keitimai	k e j t i1 m a j
keičiasi	k e1 j1 ts1 e s i
keletas	k ea1 l e t a s
keletu	k ea1 l e t u
keletą	k ea1 l e t aa
keli	k e l i1
keliais	k e l e1 j1 s
keliama	k e l e m a
kelias	k e l e s
keliaudami	k e l e1a w d a m i
keliauja	k e l e1a w j e
keliaujančių	k e l e1a w j e n ts1 uu
keliaujančiųjų	k e l e1a w j e n ts1 uu j uu
keliautojai	k e l e1a w t oo j e j
kelio	k ea1 l oo
kelioms	k e l o1o m s
kelionę	k e l oo1 n ea
kelios	k ea1 l oo s
kelis	k e l i1 s
kelių	k e l uu1
kelmas	k e1a l m a s
kelti	k e1a l t i
keramikos	k e r aa1 m i k oo s
kernavė	k e r n a v ee1
kernavėje	k e r n a v ee j e1
kernavės	k e r n a v ee s
kernius	k e1 r1 n u s
kerta	k e1 r1 t a
kertiniais	k e r t i1 n e j s
keterų	k e t e r uu1
keturi	k e t u r i1
keturiais	k e t u r e1 j1 s
keturias	k ea1 t u r e s
keturiasdešimt	k ea1 t u r e z d e s1 i m t
keturiasdešimtaisiais	k e t u r e z d e s1 i m t a1 j1 s e j s
keturiasdešimties	k ea1 t u r e z d e s1 i m t ie s
keturiese	k e t u r i1e s e
keturiolikos	k e t u r o1o l i k oo s
keturiolikto	k e t u r o1o l i k t oo
keturiose	k e t u r oo s e1
keturis	k ea1 t u r i s
keturių	k e t u r uu1
kiauninių	k e1 w1 n i n uu
kiaunių	k e1a w n uu
kiaunės	k e1a w n ee s
kiaušinius	k e w s1 i n u1 s
kiek	k i1e k
kiekiai	k ie1 k e j
kiekviena	k ie k v ie n a1
kiekvienas	k ie k v i1e n a s
kiekvienos	k ie k v ie n oo s
kietas	k i1e t a s
kietėjo	k ie t e1e j oo
kilmėms	k i l m e1e m s
kilmės	k i l m ee s
kilogramo	k i l o g r aa1 m oo
kilogramus	k i l o g r a m u1 s
kilogramų	k i l o g r aa1 m uu
kilome	k i1 l oo m e
kilometrai	k i l o m e1 t r a j
kilometras	k i l o m e1 t r a s
kilometrinius	k i l o m e1 t r i n u s
kilometro	k i l o m e1 t r oo
kilometru	k i l o m e t r u1
kilometrus	k i l o m e t r u1 s
kilometrą	k i l o m e1 t r aa
kilometrų	k i l o m e1 t r uu
kilpas	k i1 l p a s
kilti	k i1 l t i
kilusi	k i1 l u s i
kinai	k i1 n a j
kinijos	k i1 n i j oo s
kinta	k i1 n1 t a
kintamas	k i1 n1 t a m a s
kinų	k i1 n uu
kita	k i t a1
kitai	k i1 t a j
kitaip	k i t a1 j1 p
kitais	k i t a1 j1 s
kitam	k i t a1a m
kitas	k i t a s
kiti	k i t i1
kitimai	k i t i1 m a j
kito	k i1 t oo
kitokie	k i t o1o k ie
kitos	k i t oo s
kitose	k i t oo s e1
kituose	k i t uo s e1
kitur	k i t u1 r1
kitus	k i t u1 s
kitą	k i1 t aa
kitų	k i t uu1
kiškiai	k i1 s1 k e j
kiškinių	k i1 s1 k i n uu
kiškis	k i1 s1 k i s
kiškius	k i s1 k u1 s
kiškių	k i1 s1 k uu
kiškį	k i1 s1 k ii
klajojo	k l a j o1o j oo
klajoję	k l a j o1o j ea
klajoklio	k l a j oo1 k l oo
klajoklius	k l a j oo k l u1 s
klajoklių	k l a j oo1 k l uu
klanai	k l a n a1 j1
klanų	k l a n uu1
klasikiniame	k l a s i k i1 n e m e
klausimas	k l a1a w s i m a s
klausimu	k l a1a w s i m u
klausimų	k l a1a w s i m uu
klausosi	k l a1 w1 s oo s i
klausą	k l a w s aa
klesti	k l e s t i
klestinčiu	k l ea1 s t i n ts1 u
klimato	k l i1 m a t oo
klimatu	k l i1 m a t u
kliu	k l u
klodus	k l oo d u1 s
knygą	k n ii1 g aa
ko	k oo1
kodeksų	k o1 d e k s uu
kodėl	k oo d ee1 l
kojomis	k o1o j oo m i s
kojų	k o1o j uu
kokios	k oo k oo s
kokius	k o1o k u s
koks	k o1o k s
kokį	k o1o k ii
kol	k oo1 l
kolekcija	k o l e1 k ts i j e
kolekcijomis	k o l e1 k ts i j oo m i s
kolonistų	k o l o n i1 s t uu
komiteto	k o m i t e1 t oo
kompiuterių	k o m p u1 t e r uu
kompleksas	k o m p l e1 k s a s
komplekso	k o m p l e1 k s oo
kompleksu	k o m p l e k s u1
kompleksą	k o m p l e1 k s aa
kompleksų	k o m p l e1 k s uu
kondoro	k o n d o1 r oo
konkreti	k o n k r e t i1
konkretūs	k o n k r e1 t uu s
konkrečius	k o n k r e ts1 u1 s
konkurentais	k o n k u r e1 n1 t a j s
konkurentų	k o n k u r e1 n1 t uu
konkuruoja	k o n k u r u1o j e
konkuruojančius	k o n k u r u1o j e n ts1 u s
konstitucija	k o n s t i t u1 ts i j e
konstrukcija	k o n s t r u1 k ts i j e
konstrukcijos	k o n s t r u1 k ts i j oo s
konstrukciją	k o n s t r u1 k ts i j ea
kontakto	k o n t aa1 k t oo
kontaktą	k o n t aa1 k t aa
kontrolės	k o n t r o1 l ee s
kontūras	k o1 n t uu r a s
koralai	k o r aa1 l a j
koralų	k o r aa1 l uu
koridorius	k o r i1 d oo r u s
kosulio	k o1o s u l oo
kosėju	k o1o s ee j u
kotryna	k o t r ii n a1
kotrynos	k o t r ii1 n oo s
kovos	k oo v oo1 s
krante	k r a n t e1
krantuose	k r a n t uo s e1
krantus	k r a n t u1 s
kraujagyslių	k r a w j ea1 g ii s l uu
kraujo	k r a1 w1 j oo
kraštovaizdis	k r a s1 t o1o v a j z d i s
kraštovaizdžio	k r a s1 t o1o v a j z1 dz1 oo
kraštuose	k r a s1 t uo s e1
kraštą	k r aa1 s1 t aa
kraštų	k r a s1 t uu1
kreives	k r e j v e1 s
kremuotų	k r e m u1o t uu
krenta	k r e1 n1 t a
krepšelį	k r e p s1 ea1 l ii
krepšys	k r e p s1 ii1 s
krikščioniško	k r i k s1 ts1 o1o n i s1 k oo
krikščioniškoji	k r i k s1 ts1 o1o n i s1 k oo j i
krikščioniškojo	k r i k s1 ts1 o1o n i s1 k oo j oo
krikščioniškos	k r i k s1 ts1 o1o n i s1 k oo s
krikščionišką	k r i k s1 ts1 o1o n i s1 k aa
krikščionių	k r i k s1 ts1 o1o n uu
krikščionybė	k r i k s1 ts1 oo n i1i b ee
krikščionybės	k r i k s1 ts1 oo n i1i b ee s
krikščionė	k r i k s1 ts1 o1o n ee
kriokliais	k r oo k l e1 j1 s
krioklio	k r oo1 k l oo
kriokliu	k r oo k l u1
krioklių	k r oo k l uu1
krioklyje	k r oo k l ii j e1
krioklys	k r oo k l ii1 s
krioklį	k r oo1 k l ii
kris	k r i1 s
kristų	k r i1 s t uu
kritikuojama	k r i t i k u1o j e m a
kritulių	k r i t u l uu1
krize	k r i z e1
krizę	k r i1 z ea
kryptimis	k r ii p t i m i1 s
kryžiai	k r ii1 z1 e j
kryžiaus	k r ii1 z1 e w s
kryžiuočiais	k r ii z1 uo1 ts1 e j s
kryžiuočių	k r ii z1 uo1 ts1 uu
kryžių	k r ii1 z1 uu
krūmas	k r u1u m a s
krūmo	k r u1u m oo
krūmų	k r u1u m uu
kultu	k u1 l t u
kultūrinį	k u l t uu1 r i n ii
kultūroje	k u l t uu1 r oo j e
kultūros	k u l t uu1 r oo s
kunigaikštis	k u n i g a1a j k s1 t i s
kunigaikštyste	k u n i g a j k s1 t ii s t e1
kunigaikštystės	k u n i g a j k s1 t ii1 s t ee s
kunigaikščių	k u n i g a1a j k s1 ts1 uu
kuomet	k uo m e1 t
kupstas	k u1 p s t a s
kur	k u1 r1
kuri	k u r i1
kuria	k u r e
kuriais	k u r e1 j1 s
kuriame	k u r e m e1
kuriantis	k u1 r e n t i s
kurias	k u r e1 s
kurie	k u r ie1
kuriems	k u r i1e m s
kurio	k u r oo1
kurioje	k u r oo j e1
kurios	k u r oo1 s
kuriose	k u r oo s e1
kuris	k u r i1 s
kuriuose	k u r uo s e1
kurią	k u r ea1
kurių	k u r uu1
kurs	k u1 r1 s
kurso	k u1 r s oo
kursu	k u1 r s u
kurtis	k u r t i s
kurį	k u r ii1
kvadratiniai	k v a d r aa1 t i n e j
kvadratiniu	k v a d r aa1 t i n u
kvadratinių	k v a d r aa1 t i n uu
kvapą	k v aa1 p aa
kybo	k i1i b oo
kyla	k ii1 l a
ką	k aa1
kėlimo	k ee l i1 m oo
kūnas	k u1u n a s
kūne	k u1u n e
kūno	k u1u n oo
kūną	k u1u n aa
kūrė	k u1u r ee
laba	l a b a
labai	l a b a j
labiau	l a b e1 w1
labiausiai	l a b e1a w s e j
laboratoriją	l a b o r a t o1 r i j ea
lai	l a1 j1
laibas	l a1a j b a s
laidojami	l a1a j d oo j e m i
laidojimo	l a1a j d oo j i m oo
laidoti	l a1a j d oo t i
laikais	l a j k a1 j1 s
laikinas	l a1 j1 k i n a s
laikinų	l a j k i n uu1
laikoma	l a1 j1 k oo m a
laikome	l a1 j1 k oo m e
laikomi	l a1 j1 k oo m i
laikomos	l a1 j1 k oo m oo s
laikosi	l a1 j1 k oo s i
laikotarpi	l a j k o1o t a r p i
laikotarpiais	l a j k o1o t a r p e j s
laikotarpio	l a j k o1o t a r p oo
laikotarpis	l a j k o1o t a r p i s
laikotarpiu	l a j k o1o t a r p u
laikotarpyje	l a j k o1o t a r p ii j e
laikotarpį	l a j k o1o t a r p ii
laiką	l a j k aa
laikų	l a j k uu
laimei	l a1a j m e j
laimė	l a1a j m ee
laipsnį	l a1a j p s n ii
laiptai	l a1a j p t a j
laiptais	l a1a j p t a j s
laiptus	l a1a j p t u s
laiptų	l a1a j p t uu
laisvo	l a1 j1 s v oo
laivui	l a1 j1 v u j
laivų	l a j v uu
laiškus	l a1a j s1 k u s
langų	l a n g uu1
lankas	l a1 n1 k a s
lanko	l a1 n1 k oo
lankomiausia	l a n k oo m e w s e
lankomiausių	l a n k oo m e w s uu
lankytinų	l a n k i1i t i n uu
lankėsi	l a1 n1 k ee s i
lapes	l a p e1 s
lapės	l aa1 p ee s
latvijos	l aa1 t v i j oo s
latviją	l aa1 t v i j ea
laukiniai	l a w k i1 n e j
lauko	l a1 w1 k oo
laukuose	l a w k uo s e1
laukus	l a w k u1 s
laukų	l a w k uu1
laupo	l a1 w1 p oo
laviną	l aa1 v i n aa
lavos	l aa1 v oo s
ledinė	l e d i1 n ee
ledo	l ea1 d oo
ledu	l e d u1
ledynai	l e d i1i n a j
ledynas	l e d i1i n a s
ledyne	l e d i1i n e
ledynei	l e d ii1 n e j
ledyno	l e d i1i n oo
ledynų	l e d i1i n uu
legenda	l e g e n d a1
legendos	l e g e1 n1 d oo s
legendą	l e g e1 n1 d aa
legendų	l e g e1 n1 d uu
leidimas	l e j d i1 m a s
leido	l e1a j d oo
leidžiasi	l e1a j dz1 e s i
leisdavo	l e1a j z d a v oo
lengva	l e n g v a
lengvai	l e n g v a j
lenkai	l e1a n k a j
lenkijai	l e1a n k i j e j
liaudies	l e1a w d ie s
liaukų	l e1 w1 k uu
liekana	l ie1 k a n a
liekanos	l ie1 k a n oo s
liekanų	l ie1 k a n uu
liemenį	l i1e m e n ii
liepsnoje	l ie p s n oo j e1
lietuviškieji	l ie t u1 v i s1 k ie j i
lietuviškos	l ie t u1 v i s1 k oo s
lietuvių	l ie t u1 v uu
lietuvoje	l ie t u v oo j e1
lietuvos	l ie t u v oo1 s
lietuvą	l i1e t u v aa
lietūs	l i1e t uu s
ligos	l i g oo1 s
ligoti	l i g o1o t i
ligotus	l i g o1o t u s
ligų	l i g uu1
likdavo	l i1 g d a v oo
liko	l i1 k oo
linija	l i1 n i j e
linijas	l i1 n i j e s
linijos	l i1 n i j oo s
linksmos	l i n k s m oo s
linkę	l i1 n1 k ea
liūdesys	l uu d e s ii1 s
liūdnos	l uu d n oo s
liūtas	l uu1 t a s
liūčių	l u1u ts1 uu
logiška	l o1 g i s1 k a
logiškas	l o1 g i s1 k a s
loja	l o1o j e
lokiais	l oo k e1 j1 s
lotyniškojo	l oo t ii1 n i s1 k oo j oo
lubų	l u b uu1
luitai	l u1 j1 t a j
luito	l u1 j1 t oo
luitų	l u1 j1 t uu
luomai	l u1o m a j
luomus	l u1o m u s
lyderio	l i1i d e r oo
lygi	l ii g i1
lygiadienius	l ii g ea1 d ie n u s
lygiagrečiomis	l ii g e g r e ts1 oo m i1 s
lygiaverčiai	l ii g e v e1 r1 ts1 e j
lyginamas	l i1i g i n a m a s
lyginant	l i1i g i n a n t
lyginimas	l i1i g i n i m a s
lygio	l ii1 g oo
lygios	l ii g oo s
lygis	l ii1 g i s
lygiu	l ii g u
lygiui	l ii1 g u j
lygių	l ii g uu
lyguma	l ii g u m a1
lygumoje	l ii g u m oo j e1
lygumą	l i1i g u m aa
lygus	l ii g u1 s
lyriškumas	l ii r i s1 k u1 m a s
ląstelių	l aa s t ea1 l uu
ląstelė	l aa s t ea1 l ee
ląstelėmis	l aa s t ea1 l ee m i s
ląstelės	l aa s t ea1 l ee s
lėktuvo	l ee k t u1 v oo
lėmė	l e1e m ee
lėtai	l ee t a1 j1
lūšimis	l u1u s1 i m i s
lūšių	l uu s1 uu
lūšys	l u1u s1 ii s
lūžių	l uu1 z1 uu
magistrui	m a g i1 s t r u j
magistrų	m a g i1 s t r uu
magiški	m aa1 g i s1 k i
magiškų	m aa1 g i s1 k uu
maistas	m a1 j1 s t a s
maisto	m a1 j1 s t oo
maistu	m a j s t u1
maitinasi	m a j t i1 n a s i
maitintis	m a j t i1 n t i s
majų	m aa1 j uu
malio	m aa1 l oo
maltojo	m a1a l t oo j oo
mama	m a m a1
mamutais	m a m u1 t a j s
mamutas	m a m u1 t a s
mamuto	m a m u1 t oo
mamutu	m a m u t u1
mamutų	m a m u1 t uu
man	m a1a n
mangutų	m a n g u t uu
mano	m a1 n oo
manoma	m aa1 n oo m a
manyta	m a n i1i t a
manyti	m a n i1i t i
marija	m a r i j e1
maršrutų	m a r s1 r u1 t uu
mastui	m aa1 s t u j
masyvi	m a s ii v i1
masyvūs	m a s ii1 v uu s
mat	m a1 t
matematiką	m a t e m aa1 t i k aa
matematikę	m a t e m aa1 t i k ea
mato	m aa1 t oo
matome	m aa1 t oo m e
matomu	m aa1 t oo m u
matuojant	m a t u1o j e n t
matėsi	m aa1 t ee s i
mažai	m a z1 a1 j1
mažame	m a z1 a m e1
maždaug	m a z1 d a1 w1 k
mažesnes	m a z1 e s n e1 s
mažesnis	m a z1 e1 s n i s
mažiau	m a z1 e1 w1
mažiausiai	m a z1 e1a w s e j
mažiukų	m a z1 u1 k uu
mažojoje	m a z1 oo1 j oo j e
mažosios	m a z1 oo s oo s
mažuose	m a z1 uo s e1
mažėja	m a z1 e1e j e
mažų	m a z1 uu1
medienos	m e d i1e n oo s
medinių	m e d i1 n uu
medinės	m e d i1 n ee s
medinę	m e d i1 n ea
medžiagų	m ea1 dz1 e g uu
medžio	m ea1 dz1 oo
medžiodami	m e dz1 o1o d a m i
medžioja	m e dz1 o1o j e
medžioklės	m e dz1 oo1 k l ee s
medžiot	m e dz1 o1o t
medžioti	m e dz1 o1o t i
medžiotojai	m e dz1 o1o t oo j e j
medžiotojų	m e dz1 o1o t oo j uu
medžiuose	m ea1 dz1 uo s e
medžių	m ea1 dz1 uu
meksikoje	m e1 k s i k oo j e
melioracijos	m e l o r aa1 ts i j oo s
melodija	m e l o1 d i j e
melodijas	m e l o1 d i j e s
melodijos	m e l o1 d i j oo s
melodijose	m e l o1 d i j oo s e
melą	m ea1 l aa
membrana	m e m b r a n a1
menininkai	m ea1 n i n i n k a j
meno	m ea1 n oo
menui	m ea1 n u j
mergelė	m e r g ea1 l ee
mergelės	m e r g ea1 l ee s
mes	m ea1 s
meta	m ea1 t a
metais	m ea1 t a j s
meteoras	m e t e o1 r a s
meteorologiniais	m e t e o r o l o1 g i n e j s
meteorologinius	m e t e o r o l o1 g i n u s
meteorą	m e t e o1 r aa
meto	m ea1 t oo
metodika	m e t o1 d i k a
metrai	m e1 t r a j
metras	m e1 t r a s
metraštyje	m ea1 t r a s1 t ii j e
metro	m e1 t r oo
metru	m e t r u1
metrą	m e1 t r aa
metrų	m e1 t r uu
metu	m e t u1
metus	m e t u1 s
metą	m ea1 t aa
metų	m ea1 t uu
mečetė	m e ts1 e1 t ee
mečetės	m e ts1 e1 t ee s
mečetę	m e ts1 e1 t ea
miestas	m ie1 s t a s
mieste	m ie s t e1
miestelis	m ie s t ea1 l i s
miesto	m ie1 s t oo
miestu	m ie s t u1
miestui	m ie1 s t u j
miestą	m ie1 s t aa
miestų	m ie1 s t uu
mikroskopai	m i k r o s k o1 p a j
mikroskopo	m i k r o s k o1 p oo
mikroskopą	m i k r o s k o1 p aa
milijonu	m i l i j oo n u1
milijonus	m i l i j oo n u1 s
milijonų	m i l i j oo1 n uu
milžiniški	m i1 l1 z1 i n i s1 k i
milžiniško	m i1 l1 z1 i n i s1 k oo
milžiniškomis	m i1 l1 z1 i n i s1 k oo m i s
milžiniškos	m i1 l1 z1 i n i s1 k oo s
milžiniškų	m i1 l1 z1 i n i s1 k uu
mimikos	m i1 m i k oo s
mindaugo	m i1 n d a w g oo
mineralinius	m i n e r aa1 l i n u s
mineralinių	m i n e r aa1 l i n uu
mini	m i1 n i
minimas	m i1 n i m a s
minimi	m i n i m i1
ministerijos	m i n i s t e1 r i j oo s
minta	m i1 n1 t a
minėtas	m i n e1e t a s
mirties	m i r t ie1 s
mirtimi	m i r t i m i1
mirusio	m i1 r u s oo
mirusiųjų	m i1 r u s uu j uu
mirė	m i1 r ee
mis	m i1 s
misijos	m i1 s i j oo s
mistikos	m i1 s t i k oo s
mitinės	m i1 t i n ee s
mitybos	m i t i1i b oo s
mitų	m i1 t uu
miškatundrėje	m i s1 k aa1 t u n d r ee j e
miškingose	m i s1 k i1 n g oo s e
miško	m i1 s1 k oo
miškuose	m i s1 k uo s e1
miškus	m i s1 k u1 s
miškų	m i s1 k uu1
mokslininkai	m o1o k s l i n i n k a j
mokslininkė	m o1o k s l i n i n k ee
mokslininkų	m o1o k s l i n i n k uu
mokslinius	m o1o k s l i n u s
mokslą	m o1o k s l aa
mokėjo	m oo k e1e j oo
moldovą	m oo l d oo v aa
molinių	m o1 l i n uu
molio	m o1o l oo
molis	m o1o l i s
monarcho	m o n a1a r x oo
mongolai	m o n g o1 l a j
monolitas	m o n o l i1 t a s
monumentaliausių	m o n u m e n t a l e1a w s uu
moteris	m o1o t e r i s
moters	m o1o t e r s
moterų	m o1o t e r uu
mozaikų	m o z a1a j k uu
mozei	m oo1 z e j
mumija	m u1 m i j e
muziejus	m u z ie1 j u s
muziejų	m u z ie1 j uu
muzikantai	m u z i k a1a n t a j
muzikos	m u1 z i k oo s
mėginius	m e1e g i n u s
mėginių	m ee g i n uu1
mėgo	m e1e g oo
mėgsta	m e1e k s t a
mėgstamos	m e1e k s t a m oo s
mėgstu	m e1e k s t u
mėgėjai	m ee g e1e j e j
mėnulio	m ee n u1 l oo
mėnulis	m ee n u1 l i s
mėtyti	m e1e t ii t i
mįslė	m ii s l ee1
mū	m uu
mūrais	m u1u r a j s
mūras	m u1u r a s
mūrinio	m uu r i1 n oo
mūru	m uu r u
mūrų	m u1u r uu
mūsų	m u1u s uu
mūšyje	m uu1 s1 ii j e
na	n a1
nacionaliniame	n a ts i o n aa1 l i n e m e
nacionalinio	n a ts i o n aa1 l i n oo
nacionaliniuose	n a ts i o n aa1 l i n uo s e
nacionalinių	n a ts i o n aa1 l i n uu
nagais	n a g a1 j1 s
naikina	n a j k i1 n a
naikino	n a j k i1 n oo
naktimis	n a k t i m i1 s
naktį	n aa1 k t ii
nakčiai	n aa1 k ts1 e j
namai	n a m a1 j1
namelius	n a m e l u1 s
naminiai	n a m i1 n e j
naminių	n a m i1 n uu
namų	n a m uu1
nardant	n a1a r d a n t
nardo	n a1a r d oo
nariai	n a r e1 j1
narių	n a r uu1
natrio	n aa1 t r oo
natriu	n a t r u1
natūralių	n a t uu r a l uu1
natūralus	n a t uu r a l u1 s
naudingi	n a w d i1 n g i
naudojama	n a w d o1o j e m a
naudojamas	n a w d o1o j e m a s
naudojamos	n a w d o1o j e m oo s
naudojant	n a w d o1o j e n t
naudojosi	n a w d o1o j oo s i
nauja	n a w j e1
naujausius	n a w j e1a w s u s
naujieji	n a w j i1e j i
naujoji	n a w j o1o j i
naujojoje	n a w j oo1 j oo j e
naujosios	n a w j oo s oo s
naujosiose	n a w j oo1 s oo s e
naujuosius	n a w j u1o s u s
naujų	n a w j uu1
našlaičių	n a s1 l a1a j ts1 uu
ne	n e1
neatsisako	n e a t s i s aa1 k oo
neatskiriama	n e a t s k i r e m a
neatskiriami	n e a t s k i r e m i1
nebijo	n e b i1 j oo
nebuvo	n e b u1 v oo
nebūdingi	n e b uu d i1 n g i
nedaug	n e d a1 w1 k
nedideliu	n e d i1 d e l u
nedidelių	n e d i d e l uu1
nedirbamuose	n e d i r b a m uo s e1
neegzistuoja	n e e g z i s t u1o j e
negalinčiam	n e g aa1 l i n ts1 e m
negarios	n e g a r oo s
negera	n e g e r a
negiliais	n e g i l e1 j1 s
negu	n e g u
nei	n e j
neigiamo	n e1 j1 g e m oo
neigiamos	n e1 j1 g e m oo s
neilgai	n e j l g a j
neišdildoma	n e i z1 d i1 l d oo m a
neišdildomą	n e i z1 d i1 l d oo m aa
neišranki	n e i s1 r a n k i1
neišsiskiria	n e i s1 s i1 s k i r e
neišteka	n e i1 s1 t e k a
neištikima	n e i1 s1 t i k i m a
nekerta	n e1 k e r t a
nelengvas	n e l e1 n1 g v a s
nelimpa	n e l i1 m1 p a
nemažai	n e m a z1 a1 j1
nemažas	n e m aa1 z1 a s
nemokėjo	n e m oo k e1e j oo
nemuno	n ea1 m u n oo
nemėgsta	n e m e1e k s t a
nenaudoja	n e n a w d o1o j e
nenaudojo	n e n a w d o1o j oo
nenukrypstant	n e n u k r ii1 p s t a n t
nenuostabu	n e n uo s t a b u1
neolito	n e o l i1 t oo
neolitų	n e o l i1 t uu
nepakanka	n e p a k a1 n1 k a
nepaliestuose	n e p a l ie s t uo s e1
nepaliestų	n e p a l ie1 s t uu
nepamiršti	n e p a m i1 r1 s1 t i
nepaprastai	n e p a p r a s t a j
nepaprastame	n e p a p r a s t a m e1
nepaprasti	n e p a p r a s t i
nepasikeitė	n e p a s i1 k e j t ee
nepavojingi	n e p a v oo j i1 n g i
nepertraukiama	n e p e1a r t r a w k e m a
nepraktiškas	n e p r aa1 k t i s1 k a s
nepralaidžiu	n e p r a l a j dz1 u1
nepraleidžia	n e p r a l e1a j dz1 e
nepriekaištingai	n e p r ie k a j s1 t i1 n g a j
nepritariama	n e p r i t a r e m a
nepritariame	n e p r i1 t a r e m e
nerandamas	n e r a1 n1 d a m a s
nerandamos	n e r a1 n1 d a m oo s
nerasta	n e r a s t a
nereguliariai	n e r e g u l e r e1 j1
nereikia	n e r e1 j1 k e
neremontuojama	n e r e m o n t u1o j e m a
neretai	n e r e t a j
neries	n e r ie s
nes	n e s
neseniai	n e s e n e1 j1
nesiekia	n e s i1e k e
nesikeitė	n e s i1 k e j t ee
nestaugia	n e s t a1a w g e
nesuaugusių	n e s u a1a w g u s uu
nesunku	n e s u n k u1
nesustabdė	n e s u s t aa1 b d ee
nesustabdę	n e s u s t aa1 b d ea
nesuvaržyto	n e s u v a r z1 i1i t oo
nesvarbu	n e s v a r b u1
net	n e1 t
netinka	n e t i1 n1 k a
netobuli	n e t oo b u l i1
netoli	n e t oo l i1
netrikdo	n e t r i1 g d oo
netrukus	n e t r u1 k u s
neturi	n e t u1 r i
neturėjo	n e t u r e1e j oo
neužšalusiomis	n e u s1 s1 aa1 l u s oo m i s
nevengia	n e v e1a n g e
nevienpusiai	n e v ie n p u1 s e j
neįkvėpusi	n e ii k v ee1 p u s i
neįmanoma	n e ii m aa1 n oo m a
neįveikiama	n e ii v e j k e m a
nešamas	n ea1 s1 a m a s
nešė	n ea1 s1 ee
nežemiškos	n e z1 ea1 m i s1 k oo s
nežinia	n e z1 i n e1
nežino	n e z1 i1 n oo
nežinomas	n e z1 i n oo m a s
nežinomų	n e z1 i n oo m uu
niekada	n ie k a d a1
niekas	n ie1 k a s
nieko	n ie1 k oo
niekuomet	n ie k uo m e1 t
niekur	n ie1 k u r
nis	n i s
nišos	n i1 s1 oo s
norint	n oo r i n t
nors	n oo r s
norvegija	n o r v e1 g i j e
norvegijai	n o r v e1 g i j e j
norvegijoje	n o r v e1 g i j oo j e
norvegijos	n o r v e1 g i j oo s
norvegiją	n o r v e1 g i j ea
norėdami	n oo r e1e d a m i
nubaido	n u b a1 j1 d oo
nublokšti	n u b l oo1 k s1 t i
nudilina	n u d i1 l i n a
nudilinę	n u d i1 l i n ea
nufotografuoti	n u f o t o g r a f u1o t i
nugriauta	n u g r e w t a
nugrimzdo	n u g r i1 m1 z d oo
nukaršusius	n u k a r s1 u s u s
nukeliautų	n u k e l e1a w t uu
nukentėjusi	n u k e n t e1e j u s i
nukenčia	n u k e1 n1 ts1 e
nuklojo	n u k l o1o j oo
nukreipta	n u k r e j p t a
nukrypus	n u k r ii1 p u s
nukėlė	n u k e1e l ee
nukėlę	n u k e1e l ea
numatyta	n u m a t i1i t a
numatytas	n u m a t i1i t a s
nunykusi	n u n ii1 k u s i
nuo	n uo
nuolat	n uo1 l a t
nuolatinį	n uo l a t i1 n ii
nuomone	n u1o m oo n e
nuomonė	n u1o m oo n ee
nuorodų	n u1o r oo d uu
nuotaiką	n u1o t a j k aa
nuotykių	n u1o t ii k uu
nuožulniais	n uo z1 u l n e1 j1 s
nuožulniomis	n uo z1 u l n oo m i1 s
nuplaukti	n u p l a1 w1 k t i
nuplauti	n u p l a1a w t i
nurodymu	n u r o1o d ii m u
nusakoma	n u s aa1 k oo m a
nusibrėžto	n u s i b r e1e s1 t oo
nusidriekęs	n u s i d r ie1 k ea s
nusikaltėliui	n u s i k a1 l1 t ee l u j
nusileidžia	n u s i l e1a j dz1 e
nusileidžianti	n u s i l e1a j dz1 e n t i
nusimanančio	n u s i m aa1 n a n ts1 oo
nusižengimai	n u s i z1 e n g i1 m a j
nusižiūri	n u s i z1 uu1 r i
nustatyta	n u s t a t i1i t a
nustatyti	n u s t a t i1i t i
nustatė	n u s t aa1 t ee
nustelbė	n u1 s t e l b ee
nutiesti	n u t ie1 s t i
nutiestos	n u t ie s t oo s
nutolusios	n u t oo1 l u s oo s
nutraukė	n u t r a1a w k ee
nutįsęs	n u t ii1 s ea s
nuvalytų	n u v a l i1i t uu
nuėmimo	n u ee m i1 m oo
nykdavo	n ii1 g d a v oo
nykimo	n ii k i1 m oo
nyko	n ii1 k oo
nykti	n ii1 k t i
nė	n ee
nėra	n ee r a1
o	oo1
objektas	o b j e1 k t a s
objektu	o b j e k t u1
observatorija	oo p s e r v a t o1 r i j e
ola	oo l a1
olos	oo l oo1 s
olą	oo1 l aa
olų	oo l uu1
orais	oo r a1 j1 s
ordino	o1 r d i n oo
ore	oo r e1
organinių	o r g aa1 n i n uu
organizmams	o r g a n i1 z m a m s
organizmų	o r g a n i1 z m uu
organizuotai	o r g a n i z u1o t a j
originalumu	o r i g i n a l u m u1
ornamentika	o r n a m e1 n1 t i k a
ornamentuoti	o r n a m e n t u1o t i
oro	o1o r oo
ortodoksų	o r t o d o1 k s uu
ožkos	oo s1 k oo1 s
paaiškinimui	p a a1a j s1 k i n i m u j
paaiškinti	p a a1a j s1 k i n t i
pabadavusi	p a b a d aa1 v u s i
pabaiga	p a b a j g a1
pabaigoje	p a b a j g oo j e1
pabaigos	p a b a j g oo1 s
pabandė	p a b a1 n1 d ee
pabrėžė	p a b r e1e z1 ee
pabėgusios	p a b e1e g u s oo s
padainavus	p a d a j n aa1 v u s
padainavę	p a d a j n aa1 v ea
padalina	p a d a l i1 n a
padalytos	p a d a l i1i t oo s
padaryti	p a d a r i1i t i
padavimai	p a d a v i1 m a j
padeda	p a1 d e d a
padedanti	p a1 d e d a n t i
padedančių	p a1 d e d a n ts1 uu
padengta	p a d e n k t a
padidina	p a d i1 d i n a
padidės	p a d i d ee1 s
padėti	p a d e1e t i
padėtis	p a d ee t i s
padėtį	p aa1 d ee t ii
pagal	p a g a l
pagalba	p a g a1a l b a
pagalbos	p a g a1a l b oo s
pagauna	p a g a1a w n a
pagerbdavo	p a g e1 r1 b d a v oo
pagoniškos	p a g o1o n i s1 k oo s
pagoniškus	p a g o1o n i s1 k u s
pagrindiniai	p a g r i n d i1 n e j
pagrindinis	p a g r i n d i1 n i s
pagrindinius	p a g r i n d i n u1 s
pagrindinių	p a g r i n d i1 n uu
pagrindinėje	p a g r i n d i1 n ee j e
pagrindinės	p a g r i n d i1 n ee s
pagrindinę	p a g r i n d i1 n ea
pagrindinį	p a g r i n d i1 n ii
pagrindo	p aa1 g r i n d oo
pagrindu	p aa1 g r i n d u
pagyja	p a g ii1 j e
pailgas	p a i1 l g a s
pajautos	p a j e1a w t oo s
pajudindavo	p a j u1 d i n d a v oo
pajusti	p a j u1 s t i
pajėgumai	p a j ee g u1 m a j
pajėgų	p a j ee g uu1
pajūrio	p a j u1u r oo
pakankamai	p a k a1 n1 k a m a j
pakankamo	p a k a1 n1 k a m oo
pakartoja	p a k a r t o1o j e
pakeisti	p a k e1 j1 s t i
pakeldavo	p a k e1a l d a v oo
pakelti	p a k e1a l t i
pakilus	p a k i1 l u s
pakrantė	p a k r a1a n t ee
pakrantėje	p a k r a1a n t ee j e
pakrantės	p a k r a1a n t ee s
pakrantėse	p a k r a1a n t ee s e
pakrančių	p a k r a1a n ts1 uu
pakraštys	p a k r a s1 t ii1 s
pakraščių	p a k r a s1 ts1 uu1
pakyla	p a k ii1 l a
palai	p aa1 l a j
palaidoti	p a l a1a j d oo t i
palaiko	p a l a j k oo
palaikus	p aa1 l a j k u s
palaikyti	p a l a j k i1i t i
palaikų	p a l a j k uu1
palaipsniui	p a l a j p s n u1 j1
palei	p a l e j
palikdavo	p a l i1 g d a v oo
palikim	p a l i1 k i m
palikimas	p a l i k i1 m a s
palikimu	p a l i k i m u1
paliks	p a l i1 k s
palmių	p a1a l m uu
palyginimų	p a l i1i g i n i m uu
palyginti	p a l i1i g i n t i
pamatais	p a m a t a1 j1 s
pamatyti	p a m a t i1i t i
pamažu	p a m a z1 u1
paminklas	p a m i1 n1 k l a s
paminklo	p a m i1 n1 k l oo
paminklų	p a m i1 n1 k l uu
pamokslus	p a m o1o k s l u s
panamos	p a n aa1 m oo s
panaši	p a n a s1 i1
panevėžyje	p a n e v ee z1 ii j e1
paniro	p a n i1 r oo
papildomai	p a p i l d oo m a j
papildomi	p a p i l d oo m i
papildomos	p a p i l d oo m oo s
paplito	p a p l i1 t oo
paplitusi	p a p l i1 t u s i
paplitusios	p a p l i1 t u s oo s
paplitę	p a p l i1 t ea
paplitęs	p a p l i1 t ea s
paprastai	p a p r a s t a1 j1
paprastas	p a1 p r a s t a s
paprastesnis	p a p r a s t e1 s n i s
paprastesnės	p a p r a s t e s n ee s
paprasčiausiai	p a p r a s1 ts1 e1a w s e j
papročius	p aa1 p r oo ts1 u s
papuolė	p a p u1o l ee
papuošta	p a p uo s1 t a
papuoštais	p a p uo s1 t a1 j1 s
papuoštus	p a1 p uo s1 t u s
papėdės	p a p e1e d ee s
parazitai	p a r a z i1 t a j
pareikalavo	p a r e j k a l aa1 v oo
paremti	p a r e1 m1 t i
parkas	p a1a r k a s
parke	p a1a r k e
parko	p a1a r k oo
parkuose	p a1a r k uo s e
parkų	p a1a r k uu
parodos	p a r oo d oo1 s
parodydavo	p a r o1o d ii d a v oo
parą	p aa1 r aa
pas	p a s
pasak	p a s a k
pasakoja	p aa1 s a k oo j e
pasakojamas	p aa1 s a k oo j e m a s
pasakojimas	p aa1 s a k oo j i m a s
pasakojimo	p aa1 s a k oo j i m oo
pasakyti	p a s a k i1i t i
pasakų	p aa1 s a k uu
pasauli	p a s a1a w l i
pasaulinis	p a s a1a w l i n i s
pasaulio	p a s a1a w l oo
pasauly	p a s a1a w l ii
pasaulyje	p a s a1a w l ii j e
pasaulį	p a s a1a w l ii
pasiekiamas	p a s i1e k e m a s
pasiekiami	p a s ie k e m i1
pasieks	p a s ie1 k s
pasiekė	p a s i1e k ee
pasikartojantis	p a s i k a r t o1o j e n t i s
pasikartojančiais	p a s i k a r t o1o j e n ts1 e j s
pasikloja	p a s i k l o1o j e
pasilikite	p a s i l i1 k i t e
pasiliko	p a s i l i1 k oo
pasireikšti	p a s i r e1a j k s1 t i
pasirenka	p a s i1 r e n k a
pasirodyti	p a s i r o1o d ii t i
pasirūpinti	p a s i r u1u p i n t i
pasislenka	p a s i1 s l e n k a
pasisotinti	p a s i s o1o t i n t i
pasitaikius	p a s i t a1a j k u s
pasitaiko	p a s i t a1a j k oo
pasitelkus	p a s i t e1 l1 k u s
pasiturinčios	p a s i1 t u r i n ts1 oo s
pasižymi	p a s i z1 ii1 m i
pasižyminčios	p a s i z1 ii1 m i n ts1 oo s
paskalbė	p a1 s k a l b ee
paskelbė	p a s k e1a l b ee
paskirties	p a s k i r t ie1 s
paskutinieji	p a s k u t i n ie j i
paskutinioji	p a s k u t i n oo j i
paskutinis	p a s k u t i1 n i s
paskutinį	p a s k u t i1 n ii
paslaptimi	p a s l a p t i m i1
paslaptingos	p a s l a p t i1 n g oo s
paslapčių	p a s l a p ts1 uu1
paslaugos	p a s l a w g oo1 s
pasmerktas	p a1 s m e r k t a s
pastaraisiais	p a s t a r a1 j1 s e j s
pastaroji	p a s t a r o1o j i
pastaruosius	p a s t a r u1o s u s
pastarąjį	p aa1 s t a r aa j ii
pastatai	p a s t a t a1 j1
pastatymui	p a s t aa1 t ii m u j
pastatyta	p a s t a t i1i t a
pastatytas	p a s t a t i1i t a s
pastatyti	p a s t a t i1i t i
pastatytos	p a s t a t i1i t oo s
pastatytų	p a s t a t i1i t uu
pastatą	p aa1 s t a t aa
pastatė	p a s t aa1 t ee
pastatų	p a s t a t uu1
pastebimai	p a s t e b i m a1 j1
pastebėjo	p a s t e b e1e j oo
pastebėta	p a s t e b e1e t a
pastebėti	p a s t e b e1e t i
pastogės	p a s t o1o g ee s
pastoviai	p a s t oo v e1 j1
pasveria	p a1 s v e r e
pasverti	p a s v e1 r1 t i
pasvirusiais	p a s v i1 r u s e j s
pasvėrė	p a1 s v ee r ee
pat	p a1 t
patalpas	p aa1 t a l p a s
patalpoje	p a t a l p oo j e1
patarimai	p a t a r i1 m a j
patarlių	p a t a r l uu1
patarme	p aa1 t a r m e
pateka	p aa1 t e k a
patekimui	p a t e k i1 m u j
patekimą	p a t e k i1 m aa
pateko	p a t ea1 k oo
patekti	p a t e1 k t i
pati	p a t i1
paties	p a t ie1 s
patiklūs	p a t i1 k l uu s
pats	p a1 t s
patvarūs	p a t v aa1 r uu s
patvirtina	p a t v i1 r t i n a
patyręs	p a t i1i r ea s
patęs	p a t ea1 s
patęsti	p a t ea1 s t i
paukščiai	p a1 w1 k s1 ts1 e j
paukščiu	p a w k s1 ts1 u1
paukščius	p a w k s1 ts1 u1 s
paukščių	p a1 w1 k s1 ts1 uu
pauze	p a1a w z e
pauzė	p a1a w z ee
pavadinimas	p a v a d i1 n i m a s
pavadinimo	p a v a d i1 n i m oo
pavadinimu	p a v a d i1 n i m u
pavadinimą	p a v a d i1 n i m aa
pavadinimų	p a v a d i1 n i m uu
pavadino	p a v a d i1 n oo
pavadintas	p a v a d i1 n t a s
pavadintos	p a v a d i1 n t oo s
pavakary	p a v a k a r ii1
pavardę	p aa1 v a r d ea
pavasarį	p a v aa1 s a r ii
paveldu	p aa1 v e l d u
paversta	p a v e r s t a
pavidalo	p a v i1 d a l oo
pavieniui	p a v ie n u1 j1
pavieniuose	p a v ie1 n uo s e
pavienių	p a v ie1 n uu
paviršiaus	p a v i1 r1 s1 e w s
paviršinio	p a v i1 r1 s1 i n oo
paviršius	p a v i1 r1 s1 u s
paviršių	p a v i1 r1 s1 uu
pavojų	p a v oo1 j uu
pavyzdžiai	p a v ii z1 dz1 e1 j1
pavyzdžiui	p aa1 v ii z1 dz1 u j
pavėlavęs	p a v ee l aa1 v ea s
pačiais	p a ts1 e1 j1 s
pačias	p a ts1 e1 s
pačios	p a ts1 oo s
pačiu	p a ts1 u1
pašaukta	p a s1 a w k t a
pažemėjo	p a z1 e m e1e j oo
pažvelgus	p a z1 v e1 l1 g u s
pažymima	p a z1 ii1 m i m a
pažymėti	p a z1 ii m e1e t i
pele	p e l e1
peleko	p ea1 l e k oo
pelenai	p e l e n a1 j1
pelenų	p e l e n uu1
peles	p e l e1 s
pelėmis	p e l ee m i1 s
pelėnais	p e l e1e n a j s
pelės	p e l ee s
penki	p e n k i1
penkiasdešimt	p e1 n1 k e z d e s1 i m t
penkiasdešimties	p e1 n1 k e z d e s1 i m t ie s
penkiolika	p e n k o1o l i k a
penkiolikto	p e n k o1o l i k t oo
penkioliktuosius	p e n k o1o l i k t uo s u s
penkis	p e n k i1 s
penkių	p e n k uu1
penktadalis	p e n k t aa1 d a l i s
penkto	p e1 n1 k t oo
penktoji	p e n k t o1o j i
per	p e r
perdavimui	p e1a r d a v i m u j
perduodavo	p e1a r d uo d a v oo
perduoti	p e1a r d uo t i
pereina	p e1a r e j n a
periodiškumą	p e r i o d i s1 k u1 m aa
periodui	p e r i o1 d u j
perkeldavo	p e1a r k e l d a v oo
perkūno	p e r k u1u n oo
pernešė	p e1a r n e s1 ee
pernešę	p e1a r n e s1 ea
personažai	p e r s o n aa1 z1 a j
personažais	p e r s o n aa1 z1 a j s
perspėja	p e1a r s p ee j e
perstatyta	p e1a r s t a t ii t a
perteklius	p e1 r1 t e k l u s
peru	p e r u1
perėjose	p e1a r ee j oo s e
peršalau	p e1a r s1 a l a w
pieta	p ie t a
pietine	p ie t i n e1
pietinė	p ie t i1 n ee
pietinėje	p ie t i1 n ee j e
pietrytinėje	p ie t r ii t i1 n ee j e
pietus	p ie t u1 s
pietų	p ie t uu1
pievose	p i1e v oo s e
pieši	p ie s1 i
piešiniai	p ie s1 i n e1 j1
piešiniais	p ie s1 i n e1 j1 s
piešiniu	p ie1 s1 i n u
piešinius	p ie1 s1 i n u s
piešinių	p ie s1 i n uu1
piešti	p ie1 s1 t i
piktogramomis	p i k t o g r aa1 m oo m i s
piliakalniai	p i1 l e k a l n e j
piliakalniais	p i1 l e k a l n e j s
piliakalnio	p i1 l e k a l n oo
piliakalniuose	p i1 l e k a l n uo s e
piliakalnių	p i1 l e k a l n uu
pilies	p i l ie1 s
pilietinę	p i l ie1 t i n ea
pilimi	p i l i m i1
pilis	p i l i1 s
pilių	p i l uu1
pilkasis	p i l k a1 s i s
pilkos	p i l k oo s
pilkąjį	p i1 l k aa j ii
pilniu	p i l n u1
pilyje	p i l ii j e1
pilys	p i1 l ii s
pingvinu	p i n g v i n u1
piramides	p i r a m i d e1 s
piramidė	p i r a m i1 d ee
piramidėje	p i r a m i1 d ee j e
piramidės	p i r a m i1 d ee s
piramidę	p i r a m i1 d ea
piramidžių	p i r a m i1 dz1 uu
pirkiniams	p i r k i n e1a m s
pirmasis	p i r m a1 s i s
pirmiausia	p i r m e1a w s e
pirmiausiai	p i r m e1a w s e j
pirmieji	p i r m i1e j i
pirminei	p i r m i1 n e j
pirmoje	p i r m oo j e1
pirmoji	p i r m o1o j i
pirmojo	p i1 r m oo j oo
pirmojoje	p i r m oo1 j oo j e
pirmosios	p i r m oo1 s oo s
pirmykščiai	p i r m i1i k s1 ts1 e j
pirmą	p i1 r m aa
pirmąją	p i1 r m aa j ea
pirmųjų	p i r m uu1 j uu
pirštai	p i1 r1 s1 t a j
pjaunant	p j e1a w n a n t
planetoje	p l a n e1 t oo j e
planetų	p l a n e1 t uu
platesnis	p l a t e1 s n i s
plati	p l a t i1
platumų	p l a t u m uu
plaukeliais	p l a w k ea1 l e j s
plaukia	p l a1 w1 k e
plauko	p l a w k oo
plaukusiam	p l a1 w1 k u s e m
plaustų	p l a1 w1 s t uu
plazminė	p l aa1 z m i n ee
plačiai	p l a ts1 e1 j1
plačiau	p l a ts1 e1 w1
plačiausiu	p l a ts1 e1a w s u
plačios	p l a ts1 oo s
plika	p l i k a
plokštelėmis	p l oo k s1 t ea1 l ee m i s
plokšti	p l o1o k s1 t i
plokštumomis	p l oo k s1 t u m oo m i s
plokštumų	p l oo k s1 t u1 m uu
plot	p l o1o t
plota	p l oo t a
plotai	p l o1o t a j
plotas	p l o1o t a s
plote	p l o1o t e
plotis	p l oo t i s
ploto	p l o1o t oo
plotuose	p l o1o t uo s e
plotą	p l o1o t aa
pločio	p l oo1 ts1 oo
plytinės	p l ii1 t i n ee s
plytomis	p l ii1 t oo m i s
plytų	p l ii1 t uu
plėtrą	p l ee1 t r aa
plėšikaujančių	p l ee s1 i k a1a w j e n ts1 uu
plėšrieji	p l ee s1 r i1e j i
plėšrus	p l ee s1 r u1 s
plėšrūnai	p l ee s1 r uu1 n a j
plėšrūnais	p l ee s1 r uu1 n a j s
plūkto	p l uu1 k t oo
plūsti	p l u1u s t i
po	p oo
pokario	p o1o k a r oo
polifonijai	p o l i f o1 n i j e j
polifonijos	p o l i f o1 n i j oo s
polis	p oo1 l i s
politiniai	p o l i1 t i n e j
politinis	p o l i1 t i n i s
politinių	p o l i1 t i n uu
polonizuot	p o l o n i z u1o t
polonizuota	p o l o n i z u1o t a
pomirtinę	p oo m i r t i1 n ea
pomirtinį	p oo m i r t i1 n ii
populiacijai	p o p u l ea1 ts i j e j
populiarėjančios	p o p u l e r e1e j e n ts1 oo s
pora	p oo r a1
porai	p o1o r a j
poros	p oo r oo1 s
portalus	p o r t a l u1 s
porą	p o1o r aa
porūšiai	p o1o r uu s1 e j
porūšių	p o1o r uu s1 uu
posakių	p o1o s a k uu
posmelį	p oo s m ea1 l ii
požeminiai	p oo z1 e m i1 n e j
požeminio	p oo z1 e m i1 n oo
požeminis	p oo z1 e m i1 n i s
požeminių	p oo z1 e m i1 n uu
požeminė	p oo z1 e m i1 n ee
požiūris	p o1o z1 uu r i s
požiūrį	p o1o z1 uu r ii
prabėgusiais	p r a b e1e g u s e j s
pradėjo	p r a d e1e j oo
pradėjus	p r a d e1e j u s
pradėtas	p r a d e1e t a s
pradėti	p r a d e1e t i
pradėtos	p r a d ee t oo s
pradžioje	p r a dz1 oo j e1
pradžios	p r a dz1 oo1 s
pradžių	p r a dz1 uu1
praeityje	p r a e j t ii j e1
prakaito	p r a k a j t oo
praktiškai	p r aa1 k t i s1 k a j
pranašui	p r aa1 n a s1 u j
prapuolė	p r a p u1o l ee
prarado	p r a r aa1 d oo
prasideda	p r a s i1 d e d a
prasidėjo	p r a s i d e1e j oo
pratęsti	p r a t ea1 s t i
pravardę	p r aa1 v a r d ea
praėjimai	p r a ee j i1 m a j
praėjimų	p r a ee j i1 m uu
prašau	p r a s1 a1 w1
prašoma	p r aa1 s1 oo m a
prekybiniais	p r e k i1i b i n e j s
prekybos	p r e k i1i b oo s
prie	p r ie
prieblandą	p r i1e b l a n d aa
priedainių	p r i1e d a j n uu
priegaidė	p r i1e g a j d ee
priegaidės	p r i1e g a j d ee s
prieglobsčiu	p r i1e g l oo p s1 ts1 u
prieglobsčių	p r i1e g l oo p s1 ts1 uu
prieinamose	p r i e j n a m oo s e1
priekio	p r i1e k oo
prietaisais	p r i1e t a j s a j s
prietaisų	p r i1e t a j s uu
prieš	p r ie1 s1
priešai	p r i1e s1 a j
priešas	p r i1e s1 a s
priešistorinės	p r ie s1 i s t o1 r i n ee s
priešistorės	p r i1e s1 i s t oo r ee s
priešiški	p r i1e s1 i s1 k i
priešpilniu	p r i1e s1 p i l n u
priešų	p r i1e s1 uu
priežasties	p r ie z1 a s t ie1 s
priežastys	p r i1e z1 a s t ii s
priežasčių	p r ie z1 a s1 ts1 uu1
prijungta	p r i j u n k t a
priklausanti	p r i k l a1 w1 s a n t i
priklausantis	p r i k l a1 w1 s a n t i s
priklausančios	p r i k l a1 w1 s a n ts1 oo s
priklauso	p r i k l a1 w1 s oo
priklausomai	p r i k l a1 w1 s oo m a j
priklausomi	p r i k l a1 w1 s oo m i
primityvių	p r i m i t ii v uu1
princesėms	p r i n ts e1 s ee m s
principas	p r i1 n ts i p a s
principu	p r i1 n ts i p u
pripažino	p r i p a z1 i1 n oo
pripildę	p r i p i1 l d ea
prisidėjo	p r i s i d e1e j oo
prisilietimo	p r i s i l ie t i1 m oo
prisitaikę	p r i s i t a1a j k ea
priskaičiuojama	p r i s k a j ts1 u1o j e m a
priskaičiuota	p r i s k a j ts1 u1o t a
priskiriamos	p r i1 s k i r e m oo s
priskiriantys	p r i1 s k i r e n t ii s
priskirti	p r i s k i1 r t i
pritaikyta	p r i t a1a j k ii t a
privačia	p r i v a ts1 e1
priėmimu	p r i ee m i m u1
priėmė	p r i1 ee m ee
pro	p r oo
procentų	p r o1 ts e n t uu
proceso	p r o ts e1 s oo
procesu	p r o ts e s u1
procesus	p r o ts e s u1 s
procesą	p r o ts e1 s aa
produkto	p r o d u1 k t oo
produktu	p r o d u k t u1
produktų	p r o d u1 k t uu
profesorius	p r o f e1 s o r u s
progai	p r o1o g a j
progos	p r o1o g oo s
properšomis	p r o1o p e r s1 oo m i s
proporcingo	p r o p o r ts i1 n g oo
protingoms	p r oo t i1 n g oo m s
protingos	p r oo t i1 n g oo s
protėvis	p r o1o t ee v i s
provincija	p r o v i1 n ts i j e
puikiai	p u1 j1 k e j
pulti	p u1 l t i
pumomis	p u1 m oo m i s
puola	p u1o l a
puolančiųjų	p u1o l a n ts1 uu j uu
puošiančios	p uo1 s1 e n ts1 oo s
puošti	p uo1 s1 t i
pusantro	p u s a1 n1 t r oo
puse	p u s e1
pusiaujo	p u s e1a w j oo
pusių	p u1 s uu
pusrutulyje	p u1 s r u t u l ii j e
pustrečių	p u s t r e ts1 uu1
pusėje	p u1 s ee j e
puvo	p u1 v oo
pučia	p u1 ts1 e
pušynai	p u s1 i1i n a j
pėdas	p e1e d a s
pėdose	p ee d oo s e1
pėdsakų	p e1e t s a k uu
pėdų	p ee d uu1
pūsti	p uu1 s t i
raganosiai	r a g a n oo1 s e j
raginėmis	r a g i1 n ee m i s
raibuliuojantį	r a j b u l u1o j e n t ii
raidą	r a1 j1 d aa
raiteliai	r a1 j1 t e l e j
raiteliais	r a1 j1 t e l e j s
raižyba	r a j z1 i1i b a
rajono	r a j o1 n oo
rajonuose	r a j o1 n uo s e
ramiuose	r a m uo s e
rampos	r a1a m p oo s
ramybe	r a m i1i b e
randama	r a n d a m a
randamos	r a1 n1 d a m oo s
ranka	r a n k a
rankraščių	r a1 n1 k r a s1 ts1 uu
ras	r a1 s
rasta	r a s t a
rastas	r aa1 s t a s
rasti	r a1 s t i
rastos	r a s t oo s
ratais	r aa1 t a j s
ratas	r aa1 t a s
rato	r aa1 t oo
raudonąją	r a w d o1o n aa j ea
rašoma	r aa1 s1 oo m a
rašome	r aa1 s1 oo m e
raštai	r aa1 s1 t a j
rašytiniuose	r a s1 i1i t i n uo s e
rašė	r a s1 ee
reformacijai	r e f o r m aa1 ts i j e j
reginys	r e g i n ii1 s
regionas	r e g i o1 n a s
regione	r e g i o n e1
regioniniai	r e g i o1 n i n e j
regioną	r e g i o1 n aa
regionų	r e g i o1 n uu
regis	r ea1 g i s
reguliuoja	r e g u l u1o j e
reguliuoti	r e g u l u1o t i
regą	r ea1 g aa
reikalaujama	r e j k a l a1a w j e m a
reikalingas	r e j k a l i1 n g a s
reikalų	r e j k a l uu1
reikia	r e1 j1 k e
reikėtų	r e j k e1e t uu
reikš	r e1 j1 k s1
reikšme	r e1a j k s1 m e
reikšmingiausių	r e j k s1 m i n g e1a w s uu
reikšmės	r e j k s1 m ee s
reikšmę	r e1a j k s1 m ea
reiškia	r e1a j s1 k e
reiškinio	r e1a j s1 k i n oo
reiškiniui	r e1a j s1 k i n u j
reiškinys	r e j s1 k i n ii1 s
reiškė	r e1a j s1 k ee
religiniai	r e l i1 g i n e j
religinis	r e l i1 g i n i s
religinė	r e l i1 g i n ee
relikvijų	r e l i1 k v i j uu
reljefais	r e l j e1 f a j s
reljefo	r e l j e1 f oo
remontas	r e m o1 n t a s
rengdavo	r e1 n1 g d a v oo
rengiami	r e n g e m i1
renginys	r e n g i n ii1 s
renka	r e1 n1 k a
renkami	r e n k a m i1
respublikoje	r e s p u1 b l i k oo j e
respublikos	r e s p u1 b l i k oo s
restauruoti	r e s t a w r u1o t i
retesnis	r e t e1 s n i s
retos	r e t oo s
retus	r e t u1 s
retų	r e t uu1
rezervatuose	r e z e r v aa1 t uo s e
ribas	r i b a1 s
riestais	r ie s t a1 j1 s
rifai	r i1 f a j
rimtais	r i m t a1 j1 s
ritmas	r i1 t m a s
ritmikai	r i1 t m i k a j
ritualines	r i t u aa1 l i n e s
ritualus	r i t u a l u1 s
ritulį	r i1 t u l ii
rodantis	r o1o d a n t i s
rodo	r o1o d oo
rogių	r oo1 g uu
romos	r o1 m oo s
roplių	r oo p l uu1
rumunų	r u m u1 n uu
ruonių	r u1o n uu
ruožas	r u1o z1 a s
ruožus	r u1o z1 u s
rusija	r u1 s i j e
rusijoje	r u1 s i j oo j e
rusijos	r u1 s i j oo s
rusų	r u1 s uu
rutulį	r u1 t u l ii
rytinėje	r ii t i1 n ee j e
rytus	r i1i t u s
rytą	r i1i t aa
rytų	r ii t uu1
ryšius	r ii s1 u1 s
ryškiausios	r ii s1 k e1a w s oo s
rėminę	r e1e m i n ea
rėmė	r ee1 m ee
rūmai	r u1u m a j
rūmas	r u1u m a s
rūmus	r u1u m u s
rūsys	r uu s ii1 s
rūšimi	r u1u s1 i m i
rūšims	r u1u s1 i m s
rūšis	r u1u s1 i s
rūšių	r u1u s1 uu
rūšys	r u1u s1 ii s
s	e1 s
sa	s a
sacharoje	s a x a r oo j e
sako	s aa1 k oo
sakrali	s a k r a l i
sakralinio	s a k r aa1 l i n oo
sakralinė	s a k r aa1 l i n ee
sakydavęs	s a k i1i d a v ea s
salas	s aa1 l a s
saldainiu	s a l d a j n u1
saldainių	s a l d a1 j1 n uu
saldumynų	s a l d u m i1i n uu
salių	s aa1 l uu
saloje	s a l oo j e1
saloms	s a l o1o m s
salos	s a l oo1 s
salose	s a l oo s e1
salų	s a l uu1
sampratą	s a1a m p r a t aa
san	s a1 n
sandėliu	s a1a n d ee l u
sandėlių	s a1a n d ee l uu
sanitarais	s a n i t aa1 r a j s
santykiai	s a1a n t ii k e j
santykiais	s a1a n t ii k e j s
santykis	s a1a n t ii k i s
sapnus	s a p n u1 s
sargybos	s a r g i1i b oo s
sau	s a1a w
saugių	s a w g uu1
saugo	s a w g oo
saugoma	s a1a w g oo m a
saugoti	s a1a w g oo t i
saugumo	s a w g u1 m oo
saule	s a1a w l e
saules	s a1a w l e s
saulutės	s a w l u1 t ee s
saulė	s a1a w l ee
saulėgrąžą	s a w l e1e g r aa z1 aa
saulėgrąžų	s a w l e1e g r aa z1 uu
saulėgrįžą	s a w l e1e g r ii z1 aa
saulėgrįžų	s a w l e1e g r ii z1 uu
saulėje	s a1a w l ee j e
saulės	s a1a w l ee s
saus	s a1 w1 s
sausi	s a w s i1
sausos	s a w s oo s
sausra	s a w s r a1
sausras	s a w s r a1 s
sausringose	s a w s r i1 n g oo s e
sausros	s a w s r oo1 s
sausuma	s a w s u m a1
sausumoje	s a w s u m oo j e1
sausumos	s a w s u m oo1 s
savarankiškai	s a v a r a1 n1 k i s1 k a j
savarankiškų	s a v a r a1 n1 k i s1 k uu
save	s a v e1
savimi	s a v i m i1
savitumą	s a v i t u1 m aa
savivaldybės	s a v i v a l d i1i b ee s
savo	s a1 v oo
savosios	s a v oo1 s oo s
savotiška	s a v o1o t i s1 k a
savybių	s a v i1i b uu
seisminėje	s e j s m i1 n ee j e
seisminėse	s e j s m i1 n ee s e
seklesniame	s e k l e s n e m e1
sekretoriato	s e k r e t oo r i aa1 t oo
sekundžių	s e k u1 n dz1 uu
sena	s e n a
senais	s e n a1 j1 s
senasis	s e n a1 s i s
seni	s e n i1
seniai	s e n e1 j1
seniau	s e n e1 w1
seniausiais	s e n e1a w s e j s
seniausias	s e n e1a w s e s
seniausios	s e n e1a w s oo s
seniausių	s e n e1a w s uu
seno	s ea1 n oo
senoji	s e n o1o j i
senojo	s ea1 n oo j oo
senojoje	s e n oo1 j oo j e
senolis	s e n oo1 l i s
senovines	s e n o1o v i n e s
senovinis	s e n o1o v i n i s
senovėje	s e n o1o v ee j e
senovės	s e n o1o v ee s
seną	s ea1 n aa
senųjų	s e n uu1 j uu
septintaisiais	s e p t i n t a1 j1 s e j s
septintame	s e p t i n t a m e1
septintojo	s e p t i1 n1 t oo j oo
septyni	s e p t ii n i1
septyniasdešimt	s e p t i1i n e z d e s1 i m t
septyniolika	s e p t ii n o1o l i k a
septynioliktajame	s e p t ii n o1o l i k t a j e m e
septynioliktame	s e p t ii n o1o l i k t a m e
septyniolikto	s e p t ii n o1o l i k t oo
septynioliktojo	s e p t ii n o1o l i k t oo j oo
septynis	s e p t i1i n i s
septynių	s e p t ii n uu1
serbų	s e1 r1 b uu
siauras	s e1 w1 r a s
siauros	s e w r oo s
siaurų	s e w r uu1
sibiro	s i1 b i r oo
sidabriniais	s i d a b r i1 n e j s
sidabrinėmis	s i d a b r i1 n ee m i s
sieja	s i1e j e
siekia	s i1e k e
siekiant	s i1e k e n t
siekti	s i1e k t i
siekė	s i1e k ee
sieliu	s i1e l u
sielių	s i1e l uu
sielą	s i1e l aa
siena	s i1e n a
sienas	s i1e n a s
sienele	s ie n e l e1
sienelė	s ie n ea1 l ee
sienelę	s ie n ea1 l ea
sienoje	s i1e n oo j e
sienos	s i1e n oo s
sieną	s i1e n aa
sienų	s i1e n uu
sieti	s i1e t i
signalais	s i g n aa1 l a j s
signalas	s i g n aa1 l a s
signalinio	s i g n aa1 l i n oo
signalinių	s i g n aa1 l i n uu
signalo	s i g n aa1 l oo
sija	s i j e1
sijos	s i j oo1 s
simbolis	s i1 m1 b o l i s
sintezė	s i1 n1 t e z ee
sistema	s i s t e m a1
sistemoje	s i s t e1 m oo j e
siužetuose	s u z1 e1 t uo s e
siužetų	s u z1 e1 t uu
siūloma	s u1u l oo m a
skaidomas	s k a1a j d oo m a s
skaičius	s k a1 j1 ts1 u s
skalbiamoji	s k a l b e m o1o j i
skamba	s k a1 m1 b a
skauda	s k a1 w1 d a
skaudžią	s k a1 w1 dz1 ea
skaus	s k a1 w1 s
skausmo	s k a1 w1 s m oo
skeldėjo	s k e1a l d ee j oo
skersinė	s k e r s i1 n ee
skersmens	s k e r s m e1 n1 s
skiriamas	s k i1 r e m a s
skiriamasis	s k i r e m a1 s i s
skiriasi	s k i1 r e s i
skirta	s k i r t a
skirti	s k i1 r t i
skirtingas	s k i r t i1 n g a s
skirtingo	s k i r t i1 n g oo
skirtingu	s k i r t i1 n g u
skirtingus	s k i r t i1 n g u s
skirtingų	s k i r t i1 n g uu
skirto	s k i1 r t oo
skirtumai	s k i1 r t u m a j
skirtumas	s k i1 r t u m a s
skirtą	s k i1 r t aa
skituose	s k i1 t uo s e
skleidžiamas	s k l e1 j1 dz1 e m a s
skobtos	s k oo p t oo s
skrodžia	s k r o1o dz1 e
skubėti	s k u b e1e t i
skulptūrinių	s k u l p t uu1 r i n uu
skulptūros	s k u l p t uu1 r oo s
skydai	s k ii d a j
skyriuje	s k ii1 r u j e
skyrius	s k ii1 r u s
skystas	s k i1i s t a s
slegiamas	s l ea1 g e m a s
slenksčius	s l e n k s1 ts1 u1 s
sliekus	s l i1e k u s
sloguoju	s l oo g u1o j u
sluoksniais	s l u1o k s n e j s
sluoksnis	s l u1o k s n i s
sluoksnyje	s l u1o k s n ii j e
slėgiu	s l ee g u1
slėgiui	s l ee1 g u j
slėnio	s l ee1 n oo
slėnis	s l ee1 n i s
slėniuose	s l ee n uo s e
slėnius	s l ee n u1 s
slėnyje	s l ee1 n ii j e
slėptuvių	s l ee p t u1 v uu
slūgsantis	s l uu1 k s a n t i s
smarkiai	s m a1 r1 k e j
smiltainio	s m i l t a1 j1 n oo
smulkaus	s m u l k a1 w1 s
smulkius	s m u1 l k u s
smulkus	s m u l k u1 s
smėlio	s m ee1 l oo
smėlis	s m ee1 l i s
smėlynų	s m ee l i1i n uu
smūgių	s m uu1 g uu
snapo	s n aa1 p oo
sniegas	s n ie1 g a s
soda	s o d a1
sodybose	s oo d i1i b oo s e
sos	s oo s
sostine	s o1o s t i n e
sostinė	s o1o s t i n ee
sostinę	s o1o s t i n ea
sostą	s o1o s t aa
spalvingas	s p a l v i1 n g a s
spalvingieji	s p a l v i1 n g ie j i
spalvos	s p a l v oo1 s
spartinamu	s p a1 r1 t i n a m u
sparčiai	s p a1 r1 ts1 e j
sparčiau	s p a r ts1 e1 w1
specialius	s p e ts i a l u1 s
specializuoti	s p e ts i a l i z u1o t i
specialių	s p e ts i a l uu1
specialus	s p e ts i a l u1 s
specifinės	s p e ts i1 f i n ee s
spektakli	s p e k t aa1 k l i
spektakliai	s p e k t aa1 k l e j
spinduliu	s p i1 n1 d u l u
spiralės	s p i r aa1 l ee s
sporto	s p o1 r t oo
sportuoju	s p o r t u1o j u
sportuoti	s p o r t u1o t i
sprendžiami	s p r e n dz1 e m i1
spygliai	s p ii g l e1 j1
spąstuose	s p a1a s t uo s e
spąstus	s p a1a s t u s
sraunius	s r a w n u1 s
sraunių	s r a w n uu1
srautai	s r a1 w1 t a j
sritis	s r i t i1 s
sritį	s r i1 t ii
sričių	s r i ts1 uu1
srovė	s r oo v ee1
srovę	s r oo1 v ea
stabai	s t a b a1 j1
staiga	s t a j g a1
stalinė	s t a l i1 n ee
stalų	s t a l uu1
stambesnis	s t a m b e1 s n i s
stambiais	s t a m b e1 j1 s
stambiausias	s t a m b e1a w s e s
startinės	s t a1a r t i n ee s
startinę	s t a1a r t i n ea
statant	s t aa1 t a n t
statiniai	s t a t i n e1 j1
statinys	s t a t i n ii1 s
stato	s t aa1 t oo
statomas	s t aa1 t oo m a s
statomi	s t aa1 t oo m i
statomos	s t aa1 t oo m oo s
statyba	s t a t i1i b a
statybinių	s t a t i1i b i n uu
statyboms	s t a t i1i b oo m s
statybos	s t a t i1i b oo s
statybviečių	s t a t ii b v ie ts1 uu
statydami	s t a t i1i d a m i
statymo	s t aa1 t ii m oo
statytas	s t a t i1i t a s
statyti	s t a t i1i t i
statytis	s t a t i1i t i s
statė	s t aa1 t ee
statų	s t a t uu1
staugiama	s t a w g e m a
staugimas	s t a w g i1 m a s
stačiakampio	s t a ts1 ea1 k a m p oo
stačiomis	s t a ts1 oo m i1 s
stačiąja	s t a ts1 e1a j e
stačiąją	s t aa1 ts1 ea j ea
stačių	s t a ts1 uu1
stebi	s t ea1 b i
stebima	s t ea1 b i m a
stebimi	s t e b i m i1
stebina	s t ea1 b i n a
stebino	s t ea1 b i n oo
stebint	s t ea1 b i n t
stebuklo	s t e b u1 k l oo
stebėjimai	s t e b e1e j i m a j
stebėjimo	s t e b e1e j i m oo
stebėti	s t e b e1e t i
stengiasi	s t e1a n g e s i
stengėsi	s t e1a n g ee s i
stepių	s t e1 p uu
stiklas	s t i1 k l a s
stiliuose	s t i1 l uo s e
stilius	s t i1 l u s
stilizuota	s t i l i z u1o t a
stilizuotų	s t i l i z u1o t uu
stiprumo	s t i p r u1 m oo
stipruoliai	s t i p r uo1 l e j
stiprus	s t i p r u1 s
stiprėti	s t i p r e1e t i
stiprūs	s t i1 p r uu s
stokos	s t oo k oo1 s
storio	s t oo1 r oo
storus	s t o1o r u s
stouhendžo	s t oo w h e n dz1 oo
stouhendžui	s t oo w h e n dz1 u j
stouhendžą	s t oo w h e n dz1 aa
stounhedžui	s t oo w n h e dz1 u j
stounhendžo	s t oo w n h e n dz1 oo
stounhendžui	s t oo w n h e n dz1 u j
stounhendžą	s t oo w n h e n dz1 aa
stovi	s t o1o v i
stovyklavietės	s t oo v ii k l aa1 v ie t ee s
stovėjo	s t oo v e1e j oo
straipsniai	s t r a1a j p s n e j
strateginę	s t r a t e1 g i n ea
struktūrinis	s t r u k t uu1 r i n i s
struktūros	s t r u k t uu1 r oo s
studijavo	s t u d i j ea1 v oo
stulpų	s t u l p uu1
stūkso	s t uu1 k s oo
su	s u
suakmenėjusiu	s u a k m e n e1e j u s u
suakmenėjusių	s u a k m e n e1e j u s uu
suakmenėjusį	s u a k m e n e1e j u s ii
suartėjimui	s u a r t e1e j i m u j
suaugusio	s u a1a w g u s oo
suaugusių	s u a1a w g u s uu
suaugusiųjų	s u a1a w g u s uu j uu
suaugę	s u a1a w g ea
subrendusių	s u b r e1a n d u s uu
subtilūs	s u p t i1 l uu s
sudaro	s u d aa1 r oo
sudarydavo	s u d a r i1i d a v oo
sudarymas	s u d aa1 r ii m a s
sudarymo	s u d aa1 r ii m oo
sudarytas	s u d a r i1i t a s
sudaryti	s u d a r i1i t i
sudarytos	s u d a r i1i t oo s
sudarė	s u d aa1 r ee
sudegintas	s u d ea1 g i n t a s
sudomino	s u d oo1 m i n oo
sudėjimo	s u d ee j i1 m oo
sudėtinga	s u d ee t i1 n g a
sudėtingas	s u d ee t i1 n g a s
sudėtingi	s u d ee t i1 n g i
suformuodamas	s u f o r m u1o d a m a s
suformuotas	s u f o r m u1o t a s
sugalvojo	s u g a l v o1o j oo
sugalvoti	s u g a l v o1o t i
suglumo	s u g l u1 m oo
sugriauta	s u g r e w t a
sugriautas	s u g r e1a w t a s
sugriautos	s u g r e w t oo s
sugriovė	s u g r o1o v ee
sugriuvo	s u g r u1 v oo
sugyvenimo	s u g ii v ea1 n i m oo
sujungti	s u j u1 n k t i
sujungtos	s u j u n k t oo s
sukasi	s u1 k a s i
sukelia	s u1 k e l e
sukilo	s u k i1 l oo
suklestint	s u1 k l e s t i n t
suklestėjo	s u k l e s t e1e j oo
sukurta	s u k u r t a
sukurtas	s u k u1 r t a s
sukurti	s u k u1 r t i
sukurtu	s u k u1 r t u
sukėlė	s u k e1e l ee
sumažėjo	s u m a z1 e1e j oo
sumedėjusiais	s u m e d e1e j u s e j s
sumokėt	s u m oo k ee t
sumokėti	s u m oo k e1e t i
sumūrytos	s u m u1u r ii t oo s
sunaikina	s u n a j k i1 n a
sunerimę	s u n e r i1 m ea
sunkiai	s u1 n1 k e j
sunku	s u n k u1
sunkų	s u1 n1 k uu
suomiją	s u1o m i j ea
supanti	s u1 p a n t i
supančių	s u1 p a n ts1 uu
suplaukdavo	s u p l a1 w1 g d a v oo
supurtė	s u p u1 r t ee
suranda	s u r a1 n1 d a
surasti	s u r a1 s t i
surengę	s u r e1 n1 g ea
surinkimo	s u r i n k i1 m oo
surinktos	s u r i n k t oo s
susidariusiame	s u s i d aa1 r u s e m e
susidariusių	s u s i d aa1 r u s uu
susidarė	s u s i d aa1 r ee
susidarę	s u s i d aa1 r ea
susidaręs	s u s i d aa1 r ea s
susideda	s u s i1 d e d a
susidomėjimo	s u s i d oo m e1e j i m oo
susiejusių	s u s i1e j u s uu
susietos	s u s ie t oo s
susiformavo	s u s i f o r m aa1 v oo
susiformavęs	s u s i f o r m aa1 v ea s
susijungę	s u s i j u1 n g ea
susijusių	s u s i1 j u s uu
susikerta	s u s i1 k e r t a
susirinkimas	s u s i r i n k i1 m a s
suskaičiuojama	s u s k a j ts1 u1o j e m a
susprogdintos	s u s p r oo g d i1 n t oo s
sustatyti	s u s t a t i1i t i
sustingę	s u s t i1 n g ea
sustiprinti	s u s t i1 p r i n t i
sustojimu	s u s t oo j i m u1
sutampa	s u t a1 m1 p a
sutartines	s u t a r t i n e1 s
sutartinių	s u t a r t i1 n uu
sutartinės	s u t a r t i1 n ee s
sutartinėse	s u t a r t i1 n ee s e
sutartinę	s u t a r t i1 n ea
sutartyje	s u t a r t ii j e1
suteiktas	s u1 t e j k t a s
suteikė	s u1 t e j k ee
suteka	s u1 t e k a
sutemus	s u t ea1 m u s
sutemų	s u t e m uu1
sutrukdė	s u t r u1 g d ee
suvalkijos	s u v a l k i1 j oo s
sučiupti	s u ts1 u1 p t i
suėsti	s u e1e s t i
sužeisti	s u z1 e1 j1 s t i
svaigina	s v a j g i1 n a
svaigino	s v a j g i1 n oo
svarbiausi	s v a r b e1a w s i
svarbiausios	s v a r b e1a w s oo s
svarbiausius	s v a r b e1a w s u s
svarbiausių	s v a r b e1a w s uu
svarbią	s v a1 r1 b ea
svarbių	s v a r b uu1
svarbus	s v a r b u1 s
sveiki	s v e j k i1
sveria	s v ea1 r e
sveriantys	s v ea1 r e n t ii s
sveriančio	s v ea1 r e n ts1 oo
sveriančių	s v ea1 r e n ts1 uu
sviedęs	s v i1e d ea s
svorio	s v oo1 r oo
svoris	s v oo1 r i s
svyravimai	s v ii r aa1 v i m a j
svyruoja	s v ii r u1o j e
sąlygas	s a1a l ii g a s
sąlygų	s a1a l ii g uu
sąrašą	s a1a r a s1 aa
sėjos	s ee j oo1 s
sėslus	s ee s l u1 s
sūnus	s uu n u1 s
sūnūs	s u1u n uu s
t	t ee
ta	t a1
tad	t a t
tada	t a d a1
tai	t a j
taigi	t a1 j1 g i
taigoje	t a j g oo j e1
taikiai	t a1 j1 k e j
taikingo	t a j k i1 n g oo
taip	t a1 j1 p
tais	t a1 j1 s
taisyklinga	t a j s ii k l i1 n g a
takai	t a k a1 j1
taksi	t a k s i1
tam	t a1a m
tams	t a1 m1 s
tamsai	t a1 m1 s a j
tamsoje	t a m s oo j e1
tankiu	t a n k u
tapo	t aa1 p oo
taps	t a1 p s
tapti	t a1 p t i
tapus	t aa1 p u s
tapusios	t aa1 p u s oo s
tapusį	t aa1 p u s ii
tapybos	t a p i1i b oo s
tarmių	t a r m uu1
tarmės	t a r m ee s
tarnavo	t a r n aa1 v oo
tarp	t a r p
tarpeklius	t a r p e k l u1 s
tarpeklyje	t a r p ea1 k l ii j e
tarpu	t a1a r p u
tarpupirščiuose	t a r p u1 p i r s1 ts1 uo s e
tarpusavio	t a r p u1 s a v oo
tarpusavyje	t a r p u1 s a v ii j e
tarsi	t a1 r1 s i
tarytum	t a r i1i t u m
tas	t a1 s
tau	t a1a w
tauta	t a w t a1
tautos	t a w t oo1 s
tautybei	t a w t i1i b e j
tautybę	t a w t i1i b ea
tautų	t a w t uu1
tačiau	t a ts1 e w
taškų	t a s1 k uu1
te	t e1
tebeveikiančiais	t e b e v e1 j1 k e n ts1 e j s
tebėra	t e b ee r a1
techniką	t e1 x n i k aa
technologijas	t e x n o l o1 g i j e s
teigia	t e1 j1 g e
teigiama	t e j g e m a
teises	t e1a j s e s
teisių	t e j s uu
teka	t ea1 k a
tekstas	t e1 k s t a s
tekstuose	t e1 k s t uo s e
televizorių	t e l e v i1 z o r uu
telkiniai	t e l k i n e1 j1
telkiniuose	t e l k i n uo s e1
telkinių	t e l k i n uu1
telkinys	t e l k i n ii1 s
temperatūros	t e m p e r a t uu1 r oo s
temperatūrą	t e m p e r a t uu1 r aa
temperatūrų	t e m p e r a t uu1 r uu
tempiant	t e1 m1 p e n t
tempo	t e1 m1 p oo
tempti	t e1 m1 p t i
temti	t e1a m t i
ten	t e1 n1
teorijos	t e o1 r i j oo s
teorijų	t e o1 r i j uu
terakotiniai	t e r a k oo t i n e j
terakotinė	t e r a k oo t i n ee
terakotinės	t e r a k oo t i n ee s
terakotinę	t e r a k oo t i n ea
terasoje	t e r aa1 s oo j e
terasomis	t e r aa1 s oo m i s
terasų	t e r aa1 s uu
teritorija	t e r i t o1 r i j e
teritorijai	t e r i t o1 r i j e j
teritorijoje	t e r i t o1 r i j oo j e
teritorijos	t e r i t o1 r i j oo s
teritorijose	t e r i t o1 r i j oo s e
teritoriją	t e r i t o1 r i j ea
termosus	t e1a r m o s u s
tie	t ie1
tiek	t i1e k
tiekti	t ie1 k t i
ties	t ie s
tiesia	t ie1 s e
tiesiog	t ie s o1o k
tiesioginio	t ie s o1o g i n oo
tiesos	t ie s oo1 s
tiesų	t ie s uu1
tigrais	t i1 g r a j s
tik	t i k
tikima	t i1 k i m a
tikram	t i k r a1a m
tikrasis	t i k r a1 s i s
tikriausiai	t i k r e1a w s e j
tikrųjų	t i k r uu1 j uu
tikslas	t i1 k s l a s
tiksliai	t i k s l e1 j1
tiksliam	t i k s l e1a m
tiksliau	t i k s l e1 w1
tiksliausiai	t i k s l e1a w s e j
tikslo	t i1 k s l oo
tiktai	t i k t a j
tikėjimo	t i k e1e j i m oo
tikėjimą	t i k e1e j i m aa
tikėtina	t i k e1e t i n a
tikėtinai	t i k e1e t i n a j
tinkamas	t i1 n1 k a m a s
tinklas	t i1 n1 k l a s
tinklo	t i1 n1 k l oo
tinklu	t i n k l u1
tinku	t i n k u
tinkuotos	t i n k u1o t oo s
tiria	t i1 r e
tirpimą	t i r p i1 m aa
tirps	t i1 r1 p s
tirti	t i1 r t i
to	t oo1
todėl	t oo d ee1 l
toje	t oo j e1
toji	t o1o j i
tokia	t oo k e1
tokiame	t oo k e m e1
tokias	t o1o k e s
tokie	t oo k ie1
tokio	t o1o k oo
tokios	t oo k oo s
tokiu	t o1o k u
tokiuose	t oo k uo s e1
tokią	t o1o k ea
tokių	t oo k uu1
toks	t o1o k s
tokį	t o1o k ii
tolesnę	t oo l e1 s n ea
toliau	t oo l e1 w1
tolimų	t oo l i m uu1
toly	t o1 l ii
tolyn	t oo l ii1 n
tonas	t o1 n a s
tono	t o1 n oo
tonos	t o1 n oo s
tonu	t o n u1
tonų	t o1 n uu
topografijos	t o p o g r aa1 f i j oo s
tos	t oo1 s
tradicija	t r a d i1 ts i j e
tradicijoje	t r a d i1 ts i j oo j e
tradicijos	t r a d i1 ts i j oo s
tradicinių	t r a d i1 ts i n uu
trakai	t r aa1 k a j
traktuoti	t r a k t u1o t i
trakus	t r a k u1 s
trakų	t r a k uu
traukiasi	t r a1a w k e s i
traukė	t r a1a w k ee
trejinę	t r ea1 j i n ea
trejų	t r e j uu1
trečiajam	t r e ts1 e1a j e m
trečiasis	t r e ts1 e1 s i s
trianguliacijos	t r e n g u l ea1 ts i j oo s
trigubus	t r i1 g u b u s
trijose	t r i j oo s e1
trijų	t r i j uu1
trikdomi	t r i1 g d oo m i
trilijonų	t r i l i j oo1 n uu
tris	t r i1 s
trisdešimt	t r i1 z d e s1 i m t
trisdešimties	t r i1 z d e s1 i m t ie s
trise	t r i s e1
triukšmas	t r u1 k s1 m a s
triūsą	t r uu1 s aa
trobelėse	t r oo b ea1 l ee s e
trukdavo	t r u1 g d a v oo
trukdo	t r u1 g d oo
truko	t r u1 k oo
trukti	t r u1 k t i
trumpais	t r u m p a1 j1 s
trumpesnė	t r u m p e1 s n ee
trumputės	t r u m p u1 t ee s
trumpų	t r u m p uu1
tryliktame	t r i1i l i k t a m e
trys	t r ii1 s
trūko	t r u1u k oo
trūkstant	t r u1u k s t a n t
tuko	t u1 k oo
tundroje	t u1 n d r oo j e
tundros	t u1 n d r oo s
tuo	t uo1
tuomet	t uo m e1 t
tuometinės	t uo m e t i1 n ee s
tupėdamas	t u p e1e d a m a s
turgaus	t u1 r1 g a w s
turgus	t u1 r1 g u s
turi	t u1 r i
turinio	t u1 r i n oo
turistai	t u r i1 s t a j
turistas	t u r i1 s t a s
turistui	t u r i1 s t u j
turistus	t u r i s t u1 s
turistų	t u r i1 s t uu
turiu	t u r u1
turizmas	t u r i1 z m a s
turėdami	t u r e1e d a m i
turėjo	t u r e1e j oo
turėjęs	t u r e1e j ea s
tus	t u1 s
tvarkingai	t v a r k i1 n g a j
tvirtina	t v i1 r t i n a
tvirtove	t v i r t o1o v e
tvirtų	t v i r t uu1
tyli	t ii1 l i
tyrimai	t ii r i1 m a j
tyrimais	t ii r i1 m a j s
tyrimo	t ii r i1 m oo
tyrinėjimai	t ii r i n e1e j i m a j
tyrėju	t ii r e1e j u
tyrėjų	t ii r e1e j uu
tėra	t ee r a1
tėvas	t e1e v a s
tėvo	t e1e v oo
tėčiu	t ee ts1 u1
tęsiamas	t ea1 s e m a s
tęsiasi	t ea1 s e s i
tęstinumą	t ea s t i n u1 m aa
tęsėsi	t ea1 s ee s i
tūkstantaisiais	t u1u k s t a n t a j s e j s
tūkstanti	t u1u k s t a n t i
tūkstantis	t u1u k s t a n t i s
tūkstantmetyje	t u1u k s t a n t m e t ii j e
tūkstantį	t u1u k s t a n t ii
tūkstančiai	t u1u k s t a n ts1 e j
tūkstančio	t u1u k s t a n ts1 oo
tūkstančius	t u1u k s t a n ts1 u s
tūkstančių	t u1u k s t a n ts1 uu
tų	t uu1
ugnies	u g n ie1 s
ugnikalniu	u g n i1 k a l n u
ugnikalnių	u g n i1 k a l n uu
ugnis	u g n i1 s
ukrainą	u k r a i1 n aa
undinės	u n d i1 n ee s
ungurius	u1 n1 g u r u s
uniformos	u n i f o1 r m oo s
unikaliai	u n i k a l e1 j1
unikalių	u n i k a l uu1
unikalus	u n i k a l u1 s
universiteto	u n i v e r s i t e1 t oo
uodega	uo d e g a1
uodegą	u1o d e g aa
uogų	u1o g uu
uola	uo l a1
uolienas	uo l i1e n a s
uolienoms	uo l i1e n oo m s
uolos	uo l oo1 s
uolu	uo l u1
uolą	uo1 l aa
uolų	uo l uu1
uoslę	uo1 s l ea
up	u p
upelius	u p e l u1 s
upelių	u p ea1 l uu
upes	u p e1 s
upinius	u1 p i n u s
upiu	u p u
upių	u1 p uu
upė	u1 p ee
upės	u1 p ee s
urvai	u r v a1 j1
urvas	u1 r v a s
urvo	u1 r v oo
urvus	u1 r v u s
urvą	u1 r v aa
urvų	u r v uu1
urzgimas	u r z g i1 m a s
usūriniai	u s uu1 r i n e j
utenoje	u t e n oo j e1
už	u s1
užbaigimo	u z1 b a j g i1 m oo
užburiančiais	u1 z1 b u r e n ts1 e j s
uždaros	u z1 d a r oo s
uždarytas	u z1 d a r i1i t a s
užfiksuota	u z1 f i k s u1o t a
užgožė	u1 z1 g oo z1 ee
užgrobtas	u z1 g r o1o p t a s
užima	u1 z1 i m a
užimamas	u1 z1 i m a m a s
užkopti	u s1 k oo p t i
užlieja	u z1 l i1e j e
užnemunės	u1 z1 n e m u n ee s
užnešti	u z1 n e1 s1 t i
užpakalinėmis	u s1 p a k a l i1 n ee m i s
užpiltas	u s1 p i1 l t a s
užpuola	u s1 p u1o l a
užrašus	u1 z1 r a s1 u s
užrašyti	u z1 r a s1 i1i t i
užregistruoti	u z1 r e g i s t r u1o t i
užsidaro	u s1 s i d aa1 r oo
užsienio	u1 s1 s ie n oo
užsilipa	u s1 s i1 l i p a
užsirūstina	u s1 s i r u1u s t i n a
užsitęsusios	u s1 s i t ea1 s u s oo s
užtempiami	u s1 t e m p e m i1
užtempti	u s1 t e1 m1 p t i
užtemti	u s1 t e1a m t i
užtikrina	u s1 t i1 k r i n a
užtikrino	u s1 t i1 k r i n oo
užtvanka	u1 s1 t v a n k a
užtvankas	u1 s1 t v a n k a s
užtvankos	u1 s1 t v a n k oo s
užtvarą	u1 s1 t v a r aa
užtvindydami	u s1 t v i1 n d ii d a m i
užtvindė	u s1 t v i1 n d ee
užuominų	u z1 u1o m i n uu
užėmė	u1 z1 ee m ee
užšifruotą	u s1 s1 i f r u1o t aa
vabzdžius	v a b z1 dz1 u1 s
vabzdžių	v a b z1 dz1 uu1
vadina	v a d i1 n a
vadinama	v a d i1 n a m a
vadinamas	v a d i1 n a m a s
vadinami	v a d i1 n a m i
vadinasi	v a d i1 n a s i
vadovų	v a d oo1 v uu
vadų	v a d uu1
vagas	v a g a1 s
vaidmens	v a j d m e1 n1 s
vaikas	v a1 j1 k a s
vaikų	v a j k uu1
vairavimas	v a j r aa1 v i m a s
vaistus	v a1a j s t u s
vaizdai	v a j z d a1 j1
vaizdais	v a j z d a1 j1 s
vaizdavo	v a j z d aa1 v oo
vaizdingomis	v a j z d i1 n g oo m i s
vaizdini	v a1 j1 z d i n i
vaizdinį	v a j z d i n ii
vaizdo	v a1 j1 z d oo
vakare	v a k a r e1
vakarinėje	v a k a r i1 n ee j e
vakarinės	v a k a r i1 n ee s
vakarų	v a k a r uu1
valandas	v aa1 l a n d a s
valandą	v aa1 l a n d aa
valdas	v a1a l d a s
valdininkai	v a l d i n i1 n1 k a j
valdo	v a l d oo
valdoma	v a1 l1 d oo m a
valdomas	v a1 l1 d oo m a s
valdovas	v a l d oo1 v a s
valdyme	v a1 l1 d ii m e
valdymo	v a1 l1 d ii m oo
valdymui	v a1 l1 d ii m u j
valdė	v a1 l1 d ee
valdžią	v a1 l1 dz1 ea
valgomieji	v a1a l g oo m ie j i
valgykla	v a l g ii k l a1
valiutos	v a l u1 t oo s
valkataujantys	v a l k a t a1a w j e n t ii s
valstijos	v a l s t i1 j oo s
valstijose	v a l s t i1 j oo s e
valstybes	v a l s t i1i b e s
valstybinę	v a l s t i1i b i n ea
valstybių	v a l s t i1i b uu
valstybėmis	v a l s t i1i b ee m i s
valstybėms	v a l s t i1i b ee m s
valstybės	v a l s t i1i b ee s
vandeningas	v a n d e n i1 n g a s
vandeningesnės	v a n d e n i n g e s n ee s
vandeningumas	v a n d e n i n g u1 m a s
vandeniniais	v a n d e n i1 n e j s
vandeniu	v a1a n d e n u
vandeniui	v a1a n d e n u j
vandens	v a n d e1 n1 s
vandeny	v a n d e n ii1
vandenyje	v a n d e n ii j e1
vandenynas	v a n d e n i1i n a s
vandenyno	v a n d e n i1i n oo
vandenį	v a1a n d e n ii
vandenų	v a n d e n uu1
vanduo	v a n d uo1
varda	v a r d a
vardai	v a r d a1 j1
vardas	v a1 r1 d a s
vardą	v a1 r1 d aa
variantas	v a r i a1a n t a s
varles	v a r l e s
vartais	v a r t a j s
vartojamų	v a r t o1o j e m uu
vasaros	v aa1 s a r oo s
vatikano	v a t i k aa1 n oo
veikia	v e1 j1 k e
veikiančių	v e1 j1 k e n ts1 uu
veiklai	v e1 j1 k l a j
veikli	v e j k l i1
veiklos	v e j k l oo1 s
veiklūs	v e1 j1 k l uu s
veiksmas	v e1 j1 k s m a s
veikti	v e1 j1 k t i
veisiasi	v e1 j1 s e s i
veistis	v e1 j1 s t i s
veliau	v e l e w
veltui	v e1a l t u j
velėna	v e l e1e n a
vengia	v e1a n g e
vergai	v e r g a1 j1
vergų	v e r g uu1
verpstiškas	v e1 r1 p s t i s1 k a s
versija	v e1 r s i j e
verslų	v e1 r1 s l uu
vertingiausiu	v e r t i n g e1a w s u
vertėtų	v e r t ee t uu
verčiamasi	v e1 r1 ts1 e m a s i
veržėsi	v e1 r1 z1 ee s i
vešlios	v e s1 l oo s
vežimai	v e z1 i1 m a j
vežimų	v e z1 i1 m uu
vidaus	v i d a1 w1 s
vidinis	v i d i1 n i s
viduje	v i d u j e1
viduramžių	v i d u1 r a m z1 uu
vidurdienio	v i d u1 r d ie n oo
vidurinių	v i d u r i1 n uu
vidurinė	v i d u r i1 n ee
vidurio	v i1 d u r oo
viduriu	v i1 d u r u
viduryje	v i d u r ii j e1
viduržemio	v i d u1 r z1 e m oo
vidutinis	v i d u t i1 n i s
vidutiniškai	v i d u t i1 n i s1 k a j
vien	v i1e n
viena	v ie n a1
vienai	v i1e n a j
vienam	v ie n a1a m
viename	v ie n a m e1
vienas	v i1e n a s
vienbalsiškumas	v ie n b a l s i s1 k u1 m a s
vienetas	v i1e n e t a s
vienetines	v ie n e t i n e1 s
vienetinėms	v ie n e t i1 n ee m s
vieni	v ie n i1
vieningą	v ie n i1 n g aa
vienintelis	v ie n i1 n1 t e l i s
vieninteliu	v ie n i1 n1 t e l u
vieno	v i1e n oo
vienodais	v ie n o1o d a j s
vienodo	v ie n o1o d oo
vienoje	v ie n oo j e1
vienos	v ie n oo1 s
viens	v i1e n s
vientisesnis	v ie n t i s e1 s n i s
vienu	v i1e n u
vienuoliai	v ie n uo1 l e j
vienuolika	v ie n u1o l i k a
vienuolikos	v ie n u1o l i k oo s
vienuoliktais	v ie n u1o l i k t a j s
vienuoliu	v ie n uo l u1
vienuolių	v ie n uo1 l uu
vienuolynai	v ie n uo l i1i n a j
vienuolynais	v ie n uo l i1i n a j s
vienuolynas	v ie n uo l i1i n a s
vienuolyne	v ie n uo l i1i n e
vienuolyno	v ie n uo l i1i n oo
vienuolynu	v ie n uo l i1i n u
vienuolynus	v ie n uo l i1i n u s
vienuolyną	v ie n uo l i1i n aa
vienuolynų	v ie n uo l i1i n uu
vieną	v i1e n aa
vieta	v ie t a1
vietas	v ie t a1 s
vietinei	v ie1 t i n e j
vietines	v ie1 t i n e s
vietiniai	v ie1 t i n e j
vietiniams	v ie1 t i n e m s
vietinių	v ie1 t i n uu
vietinėms	v ie1 t i n ee m s
vietoje	v ie1 t oo j e
vietomis	v ie1 t oo m i s
vietos	v ie1 t oo s
vietose	v ie1 t oo s e
vietovė	v ie t o1o v ee
vietovėje	v ie t o1o v ee j e
vietovėmis	v ie t o1o v ee m i s
vietovės	v ie t o1o v ee s
vietovėse	v ie t o1o v ee s e
vietovę	v ie t o1o v ea
vietą	v ie1 t aa
vietų	v ie1 t uu
viešpatauja	v ie s1 p a t a1a w j e
viktorijos	v i k t o1 r i j oo s
vilkai	v i l k a j
vilkams	v i l k a1a m s
vilkas	v i1 l1 k a s
vilko	v i1 l1 k oo
vilkui	v i1 l1 k u j
vilkus	v i l k u1 s
vilkų	v i l k uu
vilniaus	v i1 l n e w s
vilniui	v i1 l n u j
vilniuje	v i1 l n u j e
vilnius	v i1 l n u s
vilnių	v i1 l n uu
vingiuoja	v i n g u1o j e
vingiuojantis	v i n g u1o j e n t i s
vingiuota	v i n g u1o t a
vinguriuojantis	v i n g u r u1o j e n t i s
virtinę	v i r t i n ea
virtuvę	v i r t u1 v ea
virš	v i r s1
viršaus	v i r s1 a1 w1 s
viršuje	v i r s1 u j e1
viršumi	v i r s1 u m i1
viršutiniai	v i r s1 u t i1 n e j
viršutinėje	v i r s1 u t i1 n ee j e
viršutinės	v i r s1 u t i1 n ee s
viršutinę	v i r s1 u t i1 n ea
viršutinį	v i r s1 u t i1 n ii
viršūne	v i r s1 u1u n e
viršūnė	v i r s1 u1u n ee
viršūnėje	v i r s1 u1u n ee j e
viršūnėmis	v i r s1 u1u n ee m i s
viršūnės	v i r s1 u1u n ee s
viršūnę	v i r s1 u1u n ea
vis	v i1 s
visada	v i s a d a1
visai	v i s a1a j
visas	v i s a s
visi	v i s i1
visiškai	v i1 s i s1 k a j
viskas	v i1 s k a s
viskuo	v i1 s k uo
viso	v i1 s oo
visoje	v i s oo j e1
visos	v i s oo s
visose	v i s oo s e1
visu	v i s u1
visur	v i s u1 r1
visus	v i s u1 s
visą	v i1 s aa
visų	v i s uu1
vizoje	v i1 z oo j e
vokalo	v o k aa1 l oo
vokiečiai	v o1o k ie ts1 e j
vokiečiais	v o1o k ie ts1 e j s
vokiečių	v o1o k ie ts1 uu
voras	v o1o r a s
vos	v oo1 s
vulkaninės	v u l k aa1 n i n ee s
vykdavo	v ii1 g d a v oo
vykdomojo	v i1i g d oo m oo j oo
vyno	v ii1 n oo
vyras	v i1i r a s
vyravo	v i1i r a v oo
vyro	v i1i r oo
vyru	v i1i r u
vyrų	v i1i r uu
vystymuisi	v i1i s t ii m u j s i
vystėsi	v i1i s t ee s i
vytautas	v i1i t a w t a s
vėjai	v e1e j e j
vėjams	v e1e j e m s
vėjas	v e1e j e s
vėjų	v e1e j uu
vėliau	v ee l e1 w1
vėžius	v e1e z1 u s
vėžlių	v ee z1 l uu1
y	ii i l g o1o j i
ypatingas	ii p a t i1 n g a s
ypač	i1i p a ts1
yra	ii r a1
zanavykų	z a n a v ii1 k uu
zelandijoje	z e l a1a n d i j oo j e
zelandijos	z e l a1a n d i j oo s
zonoj	z o1 n oo j
zonoje	z o1 n oo j e
zonose	z o1 n oo s e
Čilėe	ts1 i l ee e
Čilėje	ts1 i1 l ee j e
Čilės	ts1 i1 l ee s
čaižant	ts1 a1a j z1 a n t
čia	ts1 e1
Ėstijos	ee s t i j oo s
Ėstiją	ee s t i j ea
ėda	e1e d a
ėmus	ee1 m u s
ėmė	ee1 m ee
į	ii1
įdomiausia	ii d oo m e1a w s e
įdomu	ii d oo m u1
įdubos	i1i d u b oo s
įdubų	i1i d u b uu
įeina	ii e1 j1 n a
įeiti	ii e1 j1 t i
įgaubtais	ii g a w p t a1 j1 s
įgyvendinami	ii g ii v e1a n d i n a m i
įkopė	ii k oo p ee
įkurtas	ii k u1 r t a s
įkurti	ii k u1 r t i
įkūrimo	ii k uu r i1 m oo
įkūrė	ii k u1u r ee
įkūrę	ii k u1u r ea
įminti	ii m i n t i
įprasta	ii p r a s t a
įrašyta	ii r a s1 i1i t a
įrašytas	ii r a s1 i1i t a s
įrengia	ii r e1 n1 g e
įrengimas	ii r e n g i1 m a s
įrenginio	i1i r e n g i n oo
įrenginių	ii r e n g i n uu1
įrengta	ii r e n k t a
įrengti	ii r e1 n1 k t i
įrodė	ii r o1o d ee
įsakė	ii s aa1 k ee
įsigaliojus	ii s i g a l o1o j u s
įsijungia	ii s i j u1 n g e
įsikūrė	ii s i k u1u r ee
įsikūrę	ii s i k u1u r ea
įsiruošia	ii s i r uo1 s1 e
įsiterpus	ii s i t e1 r1 p u s
įsitikina	ii s i t i1 k i n a
įsiutęs	ii s u1 t ea s
įsiūbuoti	ii s uu b u1o t i
įskaičiavus	ii s k a j ts1 ea1 v u s
įsodintą	ii s oo d i1 n t aa
įspūdi	ii s p uu1 d i
įspūdingiausias	ii s p uu d i n g e1a w s e s
įspūdingiausių	ii s p uu d i n g e1a w s uu
įspūdingo	ii s p uu d i1 n g oo
įspūdingus	ii s p uu d i1 n g u s
įspūdingą	ii s p uu d i1 n g aa
įspūdį	i1i s p uu d ii
įstatymas	ii s t aa1 t ii m a s
įstatymui	ii s t aa1 t ii m u j
įsteigė	ii1 s t e j g ee
įtaisytais	ii t a j s i1i t a j s
įtakos	i1i t a k oo s
įtaką	i1i t a k aa
įteka	ii1 t e k a
įtrūkimu	ii t r uu k i m u1
įtrūkių	i1i t r uu k uu
įtvirtinimai	ii t v i1 r t i n i m a j
įtvirtinta	ii t v i1 r t i n t a
įtvirtintas	ii t v i1 r t i n t a s
įtvirtintos	ii t v i1 r t i n t oo s
įvairi	ii v a j r i1
įvairiais	ii v a j r e1 j1 s
įvairiausios	ii v a j r e1a w s oo s
įvairios	ii v a j r oo s
įvairiose	ii v a j r oo s e1
įvairiuose	ii v a j r uo s e1
įvairių	ii v a j r uu1
įvairūs	ii v a1 j1 r uu s
įvarydama	ii v a r i1i d a m a
įveikti	ii v e1 j1 k t i
įvesta	ii v e s t a
įėjimo	ii ee j i1 m oo
įžengdavo	ii z1 e1 n1 g d a v oo
įžengiama	ii z1 e n g e m a
įžengiame	ii z1 e1 n1 g e m e
įžengti	ii z1 e1 n1 k t i
Šamano	s1 a m aa1 n oo
Šiaurės	s1 e1a w r ee s
Širvintų	s1 i r v i n t uu1
Škotija	s1 k o1 t i j e
Škotijoje	s1 k o1 t i j oo j e
Švedijoj	s1 v e1 d i j oo j
Švedijoje	s1 v e1 d i j oo j e
Švediją	s1 v e1 d i j ea
šachtų	s1 aa1 x t uu
šaka	s1 a k a1
šaknimis	s1 a k n i m i1 s
šaknų	s1 a k n uu1
šakomis	s1 a k oo m i1 s
šakos	s1 a k oo1 s
šakų	s1 a k uu1
šaldyto	s1 a1a l d ii t oo
šaldytuvu	s1 a l d ii t u v u1
šalia	s1 a l e1
šalies	s1 a l ie1 s
šalimi	s1 a l i m i1
šalinant	s1 aa1 l i n a n t
šalinimą	s1 aa1 l i n i m aa
šalių	s1 a l uu1
šalta	s1 a l t a
šaltiniai	s1 a l t i1 n e j
šaltiniuose	s1 a l t i1 n uo s e
šaltyje	s1 a1 l1 t ii j e
šalyse	s1 a l ii s e1
šalčiausio	s1 a l ts1 e1a w s oo
šamanų	s1 a m aa1 n uu
šarvai	s1 a r v a1 j1
šeimomis	s1 e j m oo m i1 s
šeimos	s1 e j m oo1 s
šeimyninę	s1 e j m i1i n i n ea
šeimų	s1 e j m uu1
šermuonėliai	s1 e r m uo n ee1 l e j
šermuonėlis	s1 e r m uo n ee1 l i s
šermuonėliui	s1 e r m uo n ee1 l u j
šešerius	s1 ea1 s1 e r u s
šeši	s1 e s1 i1
šešiasdešimt	s1 ea1 s1 e z d e s1 i m t
šešiasdešimties	s1 ea1 s1 e z d e s1 i m t ie s
šešiasdešimtuosius	s1 e s1 e z d e s1 i m t u1o s u s
šešiasdešimtų	s1 e s1 e z d e s1 i m t uu1
šešiolika	s1 e s1 o1o l i k a
šešiolikos	s1 e s1 o1o l i k oo s
šešioliktame	s1 e s1 o1o l i k t a m e
šešiolikto	s1 e s1 o1o l i k t oo
šešios	s1 ea1 s1 oo s
šešis	s1 e s1 i1 s
šešių	s1 e s1 uu1
šeštais	s1 e s1 t a1 j1 s
šešto	s1 ea1 s1 t oo
ši	s1 i1
šia	s1 e1
šiam	s1 e1a m
šiandien	s1 e1 n1 d ie n
šias	s1 e1 s
šiaurinės	s1 e w r i1 n ee s
šiaurė	s1 e1a w r ee
šiaurėje	s1 e1a w r ee j e
šiaurės	s1 e1a w r ee s
šie	s1 ie1
šiek	s1 ie k
šilta	s1 i l t a
šiltų	s1 i l t uu1
šilumos	s1 i l u m oo1 s
šimtai	s1 i m t a1 j1
šimtais	s1 i m t a1 j1 s
šimtas	s1 i1 m1 t a s
šimtmečiais	s1 i1 m1 t m e ts1 e j s
šimtmečius	s1 i1 m1 t m e ts1 u s
šimto	s1 i1 m1 t oo
šimtu	s1 i m t u1
šimtus	s1 i m t u1 s
šimtą	s1 i1 m1 t aa
šimtų	s1 i m t uu1
šio	s1 oo1
šioje	s1 oo j e1
šiol	s1 oo1 l
šios	s1 oo1 s
šis	s1 i1 s
šiuo	s1 uo1
šiuolaikinė	s1 uo l a j k i1 n ee
šiuolaikinės	s1 uo l a j k i1 n ee s
šiuolaikinę	s1 uo l a j k i1 n ea
šiuos	s1 uo1 s
šią	s1 ea1
šių	s1 uu1
šlaite	s1 l a j t e1
šlaituose	s1 l a1 j1 t uo s e
šlaitus	s1 l a j t u1 s
šlaitą	s1 l a1 j1 t aa
šmėstelėjusią	s1 m e1e s t e l ee j u s ea
šnektų	s1 n e k t uu1
šnervės	s1 n e1a r v ee s
šniokštimas	s1 n oo k s1 t i1 m a s
šonais	s1 o1o n a j s
šovė	s1 o1o v ee
štai	s1 t a1 j1
šuninių	s1 u n i1 n uu
šunys	s1 u1 n ii s
šunų	s1 u n uu1
švelnesnės	s1 v e l n e s n ee s
švelnius	s1 v e l n u1 s
švelnumas	s1 v e l n u1 m a s
šventasis	s1 v e n t a1 s i s
šventes	s1 v e n t e1 s
šventikai	s1 v e n t i1 k a j
šventojo	s1 v e1 n1 t oo j oo
šventosios	s1 v e n t oo s oo s
šventu	s1 v e n t u1
šventykla	s1 v e n t ii k l a1
šventyklos	s1 v e n t ii1 k l oo s
šventyklą	s1 v e n t ii1 k l aa
šventyklų	s1 v e n t ii1 k l uu
šventąją	s1 v e1 n1 t aa j ea
švenčiausia	s1 v e n ts1 e1a w s e
švenčių	s1 v e1 n1 ts1 uu
švyturių	s1 v ii t u r uu1
šydas	s1 ii1 d a s
šį	s1 ii1
ūdra	u1u d r a
ūdrai	u1u d r a j
ūdros	u1u d r oo s
ūdrų	u1u d r uu
ūkininkai	u1u k i n i n k a j
ūkio	u1u k oo
ūkiu	u1u k u
ūktelėjama	u1u k t e l ee j e m a
ūktelėjimas	u1u k t e l ee j i m a s
ūktelėjimu	u1u k t e l ee j i m u
ūktelėjimą	u1u k t e l ee j i m aa
ūktelėti	u1u k t e l ee t i
Žemaitijai	z1 e m a j t i1 j e j
Žemaitijos	z1 e m a j t i1 j oo s
Žemės	z1 ea1 m ee s
žaisti	z1 a1 j1 s t i
žemaičiai	z1 e m a1 j1 ts1 e j
žemaičių	z1 e m a1 j1 ts1 uu
žemdirbio	z1 e1a m d i r b oo
žemdirbyste	z1 e m d i r b ii s t e1
žeme	z1 e m e1
žemiau	z1 e m e1 w1
žemiškesnių	z1 e m i s1 k e s n uu1
žemumose	z1 e m u m oo s e1
žemutinė	z1 e m u t i1 n ee
žemutinį	z1 e m u t i1 n ii
žemyn	z1 e m ii1 n
žemė	z1 ea1 m ee
žemėlapyje	z1 e m e1e l a p ii j e
žemės	z1 ea1 m ee s
žemę	z1 ea1 m ea
žengti	z1 e1 n1 k t i
ženklai	z1 e n k l a1 j1
ženklas	z1 e1a n k l a s
ženklą	z1 e1a n k l aa
žiemai	z1 ie1 m a j
žiemos	z1 ie m oo1 s
žiemą	z1 ie1 m aa
žiemų	z1 ie m uu1
žieve	z1 ie v e1
žievę	z1 ie1 v ea
žinduolio	z1 i n d uo1 l oo
žinduolis	z1 i n d uo1 l i s
žinduoliu	z1 i n d uo l u1
žinduolių	z1 i n d uo1 l uu
žingsnis	z1 i1 n1 k s n i s
žinia	z1 i n e1
žinią	z1 i1 n ea
žinių	z1 i n uu1
žinoma	z1 i n oo m a
žinomas	z1 i n oo m a s
žinomiausi	z1 i n oo m e1a w s i
žinomiausia	z1 i n oo m e1a w s e
žinomiausias	z1 i n oo m e1a w s e s
žinomo	z1 i n oo m oo
žinomą	z1 i n oo m aa
žiogus	z1 o1o g u s
žiurkes	z1 u1 r k e s
žiurkėmis	z1 u1 r k ee m i s
žiurkės	z1 u1 r k ee s
žiūrėti	z1 uu r e1e t i
žlugimo	z1 l u g i1 m oo
žmogaus	z1 m oo g a1 w1 s
žmogų	z1 m oo1 g uu
žmona	z1 m oo n a1
žmonijos	z1 m oo n i1 j oo s
žmonių	z1 m oo n uu1
žmonėms	z1 m oo n e1e m s
žmonės	z1 m o1o n ee s
žodis	z1 oo1 d i s
žodžiais	z1 oo1 dz1 e j s
žodžius	z1 oo dz1 u1 s
žodžių	z1 oo1 dz1 uu
žoliniais	z1 oo l i1 n e j s
žolių	z1 oo l uu1
žolėmis	z1 oo l ee m i1 s
žolę	z1 oo1 l ea
žurnale	z1 u r n a l e1
žuvies	z1 u v ie1 s
žuvingos	z1 u v i1 n g oo s
žuvis	z1 u v i1 s
žuvo	z1 u1 v oo
žuvį	z1 u1 v ii
žuvų	z1 u v uu1
žvaigždynų	z1 v a j g z1 d i1i n uu
žvaigždėlapį	z1 v a j g z1 d e1e l a p ii
žvaigždės	z1 v a j g z1 d ee s
žvalgybinės	z1 v a l g i1i b i n ee s
žvejyba	z1 v e j i1i b a
žvilgtelėjus	z1 v i1 l k t e l ee j u s
žvirgždo	z1 v i1 r1 g z1 d oo
žvyro	z1 v ii1 r oo
žvėreliai	z1 v ee r ea1 l e j
žvėrelis	z1 v ee r ea1 l i s
žvėrelių	z1 v ee r ea1 l uu
žvėrių	z1 v ee r uu
žymiai	z1 ii1 m e j
žymiausių	z1 ii m e1a w s uu
žymus	z1 ii m u1 s
žymėjo	z1 ii m e1e j oo
žūva	z1 uu1 v a
